"Kod";"Nazwa";"stan w końcu czerwca;ogółem;2020;[osoba]";"stan w końcu czerwca;kobiety;2020;[osoba]";"stan w końcu czerwca;mężczyźni;2020;[osoba]";"stan w końcu czerwca;do 25 roku życia;2020;[osoba]";"stan w końcu czerwca;do 30 roku życia;2020;[osoba]";"stan w końcu czerwca;powyżej 50 roku życia;2020;[osoba]";"stan w końcu czerwca;długotrwale bezrobotni;2020;[osoba]";
0000000;"POLSKA";1026471;551003;475468;132199;279165;257341;464686;
0200000;"DOLNOŚLĄSKIE";69076;36770;32306;7579;16352;19056;28780;
0201000;"Powiat bolesławiecki";1659;939;720;226;493;400;511;
0201011;"Bolesławiec (1)";691;374;317;78;191;174;203;
0201022;"Bolesławiec (2)";253;139;114;51;89;59;89;
0201032;"Gromadka (2)";99;59;40;16;31;26;30;
0201043;"Nowogrodziec (3)";276;174;102;39;90;68;86;
0201044;"Nowogrodziec - miasto (4)";68;48;20;2;17;18;19;
0201045;"Nowogrodziec - obszar wiejski (5)";208;126;82;37;73;50;67;
0201052;"Osiecznica (2)";155;82;73;20;47;40;50;
0201062;"Warta Bolesławiecka (2)";185;111;74;22;45;33;53;
0202000;"Powiat dzierżoniowski";2150;1093;1057;189;450;706;605;
0202011;"Bielawa (1)";496;268;228;53;99;174;101;
0202021;"Dzierżoniów (1)";762;380;382;58;149;248;232;
0202033;"Pieszyce (3)";225;128;97;22;56;70;63;
0202034;"Pieszyce - miasto (4)";186;104;82;17;46;62;49;
0202035;"Pieszyce - obszar wiejski (5)";39;24;15;5;10;8;14;
0202041;"Piława Górna (1)";198;91;107;17;44;67;65;
0202052;"Dzierżoniów (2)";211;94;117;17;42;73;55;
0202062;"Łagiewniki (2)";135;76;59;8;31;31;53;
0202073;"Niemcza (3)";123;56;67;14;29;43;36;
0202074;"Niemcza - miasto (4)";66;27;39;7;14;26;22;
0202075;"Niemcza - obszar wiejski (5)";57;29;28;7;15;17;14;
0203000;"Powiat głogowski";2277;1462;815;309;579;490;1132;
0203011;"Głogów (1)";1620;1050;570;206;406;324;757;
0203022;"Głogów (2)";165;110;55;25;49;35;93;
0203032;"Jerzmanowa (2)";127;81;46;26;36;28;62;
0203042;"Kotla (2)";150;83;67;20;30;49;86;
0203052;"Pęcław (2)";98;60;38;18;24;24;60;
0203062;"Żukowice (2)";117;78;39;14;34;30;74;
0204000;"Powiat górowski";1745;982;763;258;508;395;935;
0204013;"Góra (3)";981;539;442;150;281;226;525;
0204014;"Góra - miasto (4)";542;276;266;80;141;144;267;
0204015;"Góra - obszar wiejski (5)";439;263;176;70;140;82;258;
0204022;"Jemielno (2)";151;87;64;17;47;29;89;
0204032;"Niechlów (2)";264;148;116;41;79;56;144;
0204043;"Wąsosz (3)";349;208;141;50;101;84;177;
0204044;"Wąsosz - miasto (4)";126;76;50;22;33;29;58;
0204045;"Wąsosz - obszar wiejski (5)";223;132;91;28;68;55;119;
0205000;"Powiat jaworski";1853;991;862;234;500;483;960;
0205011;"Jawor (1)";671;346;325;71;176;176;279;
0205023;"Bolków (3)";598;321;277;72;155;179;379;
0205024;"Bolków - miasto (4)";250;127;123;26;58;79;150;
0205025;"Bolków - obszar wiejski (5)";348;194;154;46;97;100;229;
0205032;"Męcinka (2)";163;81;82;26;41;30;82;
0205042;"Mściwojów (2)";141;91;50;22;46;30;72;
0205052;"Paszowice (2)";156;87;69;26;46;34;86;
0205062;"Wądroże Wielkie (2)";124;65;59;17;36;34;62;
0206000;"Powiat karkonoski";1828;910;918;162;339;576;943;
0206011;"Karpacz (1)";116;51;65;8;18;46;55;
0206021;"Kowary (1)";307;149;158;25;56;96;177;
0206031;"Piechowice (1)";144;73;71;13;25;41;65;
0206041;"Szklarska Poręba (1)";148;72;76;9;24;54;62;
0206052;"Janowice Wielkie (2)";144;76;68;9;24;43;83;
0206062;"Jeżów Sudecki (2)";162;74;88;17;36;50;76;
0206072;"Mysłakowice (2)";363;187;176;38;59;120;199;
0206082;"Podgórzyn (2)";269;138;131;29;53;79;132;
0206092;"Stara Kamienica (2)";175;90;85;14;44;47;94;
0207000;"Powiat kamiennogórski";1130;498;632;168;301;350;326;
0207011;"Kamienna Góra (1)";526;219;307;79;139;167;139;
0207022;"Kamienna Góra (2)";203;98;105;34;61;63;54;
0207033;"Lubawka (3)";269;123;146;30;65;79;91;
0207034;"Lubawka - miasto (4)";137;69;68;14;33;40;42;
0207035;"Lubawka - obszar wiejski (5)";132;54;78;16;32;39;49;
0207042;"Marciszów (2)";132;58;74;25;36;41;42;
0208000;"Powiat kłodzki";6402;3273;3129;711;1509;1701;2935;
0208011;"Duszniki-Zdrój (1)";143;72;71;11;32;35;57;
0208021;"Kłodzko (1)";921;457;464;96;189;226;400;
0208031;"Kudowa-Zdrój (1)";349;150;199;34;72;111;143;
0208041;"Nowa Ruda (1)";862;478;384;90;196;233;376;
0208051;"Polanica-Zdrój (1)";187;74;113;13;31;66;79;
0208063;"Bystrzyca Kłodzka (3)";885;495;390;119;230;206;423;
0208064;"Bystrzyca Kłodzka - miasto (4)";493;276;217;65;117;113;235;
0208065;"Bystrzyca Kłodzka - obszar wiejski (5)";392;219;173;54;113;93;188;
0208072;"Kłodzko (2)";699;345;354;89;182;163;297;
0208083;"Lądek-Zdrój (3)";343;166;177;40;90;89;165;
0208084;"Lądek-Zdrój - miasto (4)";210;111;99;20;50;56;103;
0208085;"Lądek-Zdrój - obszar wiejski (5)";133;55;78;20;40;33;62;
0208092;"Lewin Kłodzki (2)";81;39;42;8;17;28;38;
0208103;"Międzylesie (3)";355;185;170;46;100;96;197;
0208104;"Międzylesie - miasto (4)";108;54;54;13;29;39;59;
0208105;"Międzylesie - obszar wiejski (5)";247;131;116;33;71;57;138;
0208112;"Nowa Ruda (2)";543;293;250;58;120;162;271;
0208123;"Radków (3)";348;182;166;36;86;105;167;
0208124;"Radków - miasto (4)";98;56;42;10;26;25;48;
0208125;"Radków - obszar wiejski (5)";250;126;124;26;60;80;119;
0208133;"Stronie Śląskie (3)";378;181;197;40;92;97;193;
0208134;"Stronie Śląskie - miasto (4)";170;70;100;3;22;50;92;
0208135;"Stronie Śląskie - obszar wiejski (5)";208;111;97;37;70;47;101;
0208143;"Szczytna (3)";308;156;152;31;72;84;129;
0208144;"Szczytna - miasto (4)";222;104;118;22;51;68;89;
0208145;"Szczytna - obszar wiejski (5)";86;52;34;9;21;16;40;
0209000;"Powiat legnicki";1917;1078;839;213;460;496;978;
0209011;"Chojnów (1)";645;329;316;73;148;184;335;
0209022;"Chojnów (2)";478;260;218;43;105;129;295;
0209032;"Krotoszyce (2)";69;50;19;7;19;16;34;
0209042;"Kunice (2)";151;95;56;17;36;25;52;
0209052;"Legnickie Pole (2)";103;48;55;11;24;29;48;
0209062;"Miłkowice (2)";202;128;74;13;36;52;105;
0209073;"Prochowice (3)";191;117;74;37;61;45;74;
0209074;"Prochowice - miasto (4)";81;42;39;16;23;19;31;
0209075;"Prochowice - obszar wiejski (5)";110;75;35;21;38;26;43;
0209082;"Ruja (2)";78;51;27;12;31;16;35;
0210000;"Powiat lubański";1469;730;739;190;388;426;557;
0210011;"Lubań (1)";400;181;219;52;106;108;124;
0210021;"Świeradów-Zdrój (1)";146;70;76;24;43;47;57;
0210033;"Leśna (3)";377;185;192;46;96;118;164;
0210034;"Leśna - miasto (4)";146;58;88;18;36;52;55;
0210035;"Leśna - obszar wiejski (5)";231;127;104;28;60;66;109;
0210042;"Lubań (2)";167;84;83;17;38;56;72;
0210053;"Olszyna (3)";198;105;93;20;51;55;68;
0210054;"Olszyna - miasto (4)";117;61;56;8;27;33;38;
0210055;"Olszyna - obszar wiejski (5)";81;44;37;12;24;22;30;
0210062;"Platerówka (2)";51;35;16;8;10;16;20;
0210072;"Siekierczyn (2)";130;70;60;23;44;26;52;
0211000;"Powiat lubiński";1968;1265;703;245;535;443;669;
0211011;"Lubin (1)";1253;823;430;150;335;267;394;
0211022;"Lubin (2)";291;168;123;38;70;72;93;
0211032;"Rudna (2)";178;125;53;28;56;40;76;
0211043;"Ścinawa (3)";246;149;97;29;74;64;106;
0211044;"Ścinawa - miasto (4)";131;79;52;15;37;32;43;
0211045;"Ścinawa - obszar wiejski (5)";115;70;45;14;37;32;63;
0212000;"Powiat lwówecki";1632;842;790;199;407;461;798;
0212013;"Gryfów Śląski (3)";307;150;157;35;69;92;144;
0212014;"Gryfów Śląski - miasto (4)";215;108;107;23;51;66;90;
0212015;"Gryfów Śląski - obszar wiejski (5)";92;42;50;12;18;26;54;
0212023;"Lubomierz (3)";207;112;95;24;47;54;123;
0212024;"Lubomierz - miasto (4)";56;27;29;9;14;12;32;
0212025;"Lubomierz - obszar wiejski (5)";151;85;66;15;33;42;91;
0212033;"Lwówek Śląski (3)";567;317;250;72;164;137;258;
0212034;"Lwówek Śląski - miasto (4)";258;138;120;29;74;58;107;
0212035;"Lwówek Śląski - obszar wiejski (5)";309;179;130;43;90;79;151;
0212043;"Mirsk (3)";411;199;212;52;95;129;203;
0212044;"Mirsk - miasto (4)";169;87;82;26;45;45;72;
0212045;"Mirsk - obszar wiejski (5)";242;112;130;26;50;84;131;
0212053;"Wleń (3)";140;64;76;16;32;49;70;
0212054;"Wleń - miasto (4)";48;16;32;4;10;19;17;
0212055;"Wleń - obszar wiejski (5)";92;48;44;12;22;30;53;
0213000;"Powiat milicki";1015;567;448;136;276;268;446;
0213012;"Cieszków (2)";156;86;70;21;43;48;74;
0213022;"Krośnice (2)";208;107;101;35;65;49;85;
0213033;"Milicz (3)";651;374;277;80;168;171;287;
0213034;"Milicz - miasto (4)";280;151;129;31;65;69;118;
0213035;"Milicz - obszar wiejski (5)";371;223;148;49;103;102;169;
0214000;"Powiat oleśnicki";2497;1385;1112;307;627;669;885;
0214011;"Oleśnica (1)";694;375;319;63;122;209;182;
0214023;"Bierutów (3)";373;190;183;57;107;93;187;
0214024;"Bierutów - miasto (4)";174;81;93;26;46;46;88;
0214025;"Bierutów - obszar wiejski (5)";199;109;90;31;61;47;99;
0214032;"Dobroszyce (2)";125;76;49;16;40;28;33;
0214042;"Dziadowa Kłoda (2)";132;71;61;19;37;37;73;
0214053;"Międzybórz (3)";136;85;51;20;40;25;50;
0214054;"Międzybórz - miasto (4)";55;35;20;10;17;12;18;
0214055;"Międzybórz - obszar wiejski (5)";81;50;31;10;23;13;32;
0214062;"Oleśnica (2)";255;143;112;28;68;69;64;
0214073;"Syców (3)";462;280;182;62;122;122;184;
0214074;"Syców - miasto (4)";283;161;122;32;67;84;115;
0214075;"Syców - obszar wiejski (5)";179;119;60;30;55;38;69;
0214083;"Twardogóra (3)";320;165;155;42;91;86;112;
0214084;"Twardogóra - miasto (4)";164;89;75;21;48;41;61;
0214085;"Twardogóra - obszar wiejski (5)";156;76;80;21;43;45;51;
0215000;"Powiat oławski";1922;968;954;217;443;574;824;
0215011;"Oława (1)";838;404;434;90;172;260;375;
0215022;"Domaniów (2)";126;76;50;15;30;39;66;
0215033;"Jelcz-Laskowice (3)";517;277;240;57;130;146;188;
0215034;"Jelcz-Laskowice - miasto (4)";344;177;167;35;82;98;122;
0215035;"Jelcz-Laskowice - obszar wiejski (5)";173;100;73;22;48;48;66;
0215042;"Oława (2)";441;211;230;55;111;129;195;
0216000;"Powiat polkowicki";1799;1076;723;266;532;468;849;
0216013;"Chocianów (3)";481;299;182;67;126;135;246;
0216014;"Chocianów - miasto (4)";309;189;120;40;76;91;170;
0216015;"Chocianów - obszar wiejski (5)";172;110;62;27;50;44;76;
0216022;"Gaworzyce (2)";93;50;43;18;31;24;37;
0216032;"Grębocice (2)";165;105;60;26;49;42;79;
0216043;"Polkowice (3)";580;344;236;77;181;126;218;
0216044;"Polkowice - miasto (4)";474;277;197;62;141;108;183;
0216045;"Polkowice - obszar wiejski (5)";106;67;39;15;40;18;35;
0216053;"Przemków (3)";325;182;143;47;90;101;204;
0216054;"Przemków - miasto (4)";234;137;97;30;59;76;142;
0216055;"Przemków - obszar wiejski (5)";91;45;46;17;31;25;62;
0216062;"Radwanice (2)";155;96;59;31;55;40;65;
0217000;"Powiat strzeliński";1657;881;776;207;416;435;837;
0217012;"Borów (2)";152;83;69;18;35;41;73;
0217022;"Kondratowice (2)";195;109;86;20;44;53;103;
0217032;"Przeworno (2)";197;101;96;25;60;49;90;
0217043;"Strzelin (3)";861;446;415;98;201;236;459;
0217044;"Strzelin - miasto (4)";495;249;246;42;102;136;265;
0217045;"Strzelin - obszar wiejski (5)";366;197;169;56;99;100;194;
0217053;"Wiązów (3)";252;142;110;46;76;56;112;
0217054;"Wiązów - miasto (4)";89;47;42;12;21;30;43;
0217055;"Wiązów - obszar wiejski (5)";163;95;68;34;55;26;69;
0218000;"Powiat średzki";1234;623;611;143;311;367;522;
0218012;"Kostomłoty (2)";189;92;97;20;37;64;106;
0218022;"Malczyce (2)";143;75;68;27;47;30;48;
0218032;"Miękinia (2)";305;162;143;27;69;93;118;
0218043;"Środa Śląska (3)";429;225;204;43;101;136;174;
0218044;"Środa Śląska - miasto (4)";173;90;83;18;41;48;48;
0218045;"Środa Śląska - obszar wiejski (5)";256;135;121;25;60;88;126;
0218052;"Udanin (2)";168;69;99;26;57;44;76;
0219000;"Powiat świdnicki";4125;2118;2007;456;966;1218;1542;
0219011;"Świdnica (1)";1328;667;661;141;280;419;421;
0219021;"Świebodzice (1)";781;380;401;68;156;235;388;
0219032;"Dobromierz (2)";209;129;80;28;55;58;120;
0219043;"Jaworzyna Śląska (3)";236;127;109;39;76;53;79;
0219044;"Jaworzyna Śląska - miasto (4)";117;66;51;20;44;27;36;
0219045;"Jaworzyna Śląska - obszar wiejski (5)";119;61;58;19;32;26;43;
0219052;"Marcinowice (2)";143;71;72;15;34;46;42;
0219063;"Strzegom (3)";785;414;371;89;198;242;311;
0219064;"Strzegom - miasto (4)";478;250;228;44;111;157;191;
0219065;"Strzegom - obszar wiejski (5)";307;164;143;45;87;85;120;
0219072;"Świdnica (2)";391;201;190;46;106;91;118;
0219083;"Żarów (3)";252;129;123;30;61;74;63;
0219084;"Żarów - miasto (4)";134;67;67;21;37;33;32;
0219085;"Żarów - obszar wiejski (5)";118;62;56;9;24;41;31;
0220000;"Powiat trzebnicki";1848;1108;740;255;517;465;796;
0220013;"Oborniki Śląskie (3)";359;214;145;41;96;91;144;
0220014;"Oborniki Śląskie - miasto (4)";149;79;70;13;38;38;55;
0220015;"Oborniki Śląskie - obszar wiejski (5)";210;135;75;28;58;53;89;
0220023;"Prusice (3)";192;118;74;26;55;43;81;
0220024;"Prusice - miasto (4)";61;43;18;8;16;16;30;
0220025;"Prusice - obszar wiejski (5)";131;75;56;18;39;27;51;
0220033;"Trzebnica (3)";489;301;188;74;139;108;199;
0220034;"Trzebnica - miasto (4)";249;141;108;29;58;55;102;
0220035;"Trzebnica - obszar wiejski (5)";240;160;80;45;81;53;97;
0220042;"Wisznia Mała (2)";162;99;63;16;35;43;52;
0220052;"Zawonia (2)";127;81;46;18;39;36;52;
0220063;"Żmigród (3)";519;295;224;80;153;144;268;
0220064;"Żmigród - miasto (4)";226;132;94;28;62;66;117;
0220065;"Żmigród - obszar wiejski (5)";293;163;130;52;91;78;151;
0221000;"Powiat wałbrzyski";1789;986;803;201;406;468;723;
0221011;"Boguszów-Gorce (1)";611;357;254;61;132;156;298;
0221021;"Jedlina-Zdrój (1)";142;72;70;19;32;25;46;
0221031;"Szczawno-Zdrój (1)";110;54;56;13;20;27;32;
0221042;"Czarny Bór (2)";146;78;68;18;46;35;55;
0221053;"Głuszyca (3)";238;128;110;37;70;61;56;
0221054;"Głuszyca - miasto (4)";171;93;78;29;51;44;38;
0221055;"Głuszyca - obszar wiejski (5)";67;35;32;8;19;17;18;
0221063;"Mieroszów (3)";186;103;83;15;31;58;85;
0221064;"Mieroszów - miasto (4)";100;53;47;4;14;35;52;
0221065;"Mieroszów - obszar wiejski (5)";86;50;36;11;17;23;33;
0221072;"Stare Bogaczowice (2)";101;56;45;14;22;34;40;
0221082;"Walim (2)";255;138;117;24;53;72;111;
0222000;"Powiat wołowski";2017;1114;903;243;509;564;1190;
0222013;"Brzeg Dolny (3)";460;274;186;56;108;128;197;
0222014;"Brzeg Dolny - miasto (4)";348;199;149;43;82;100;143;
0222015;"Brzeg Dolny - obszar wiejski (5)";112;75;37;13;26;28;54;
0222022;"Wińsko (2)";452;244;208;58;124;134;291;
0222033;"Wołów (3)";1105;596;509;129;277;302;702;
0222034;"Wołów - miasto (4)";578;299;279;54;134;162;353;
0222035;"Wołów - obszar wiejski (5)";527;297;230;75;143;140;349;
0223000;"Powiat wrocławski";1620;897;723;174;388;420;535;
0223012;"Czernica (2)";191;103;88;29;55;55;58;
0223022;"Długołęka (2)";332;190;142;44;96;78;88;
0223032;"Jordanów Śląski (2)";35;12;23;5;8;13;15;
0223043;"Kąty Wrocławskie (3)";257;133;124;31;63;60;88;
0223044;"Kąty Wrocławskie - miasto (4)";57;28;29;6;12;11;23;
0223045;"Kąty Wrocławskie - obszar wiejski (5)";200;105;95;25;51;49;65;
0223052;"Kobierzyce (2)";227;138;89;14;43;61;82;
0223062;"Mietków (2)";56;32;24;5;16;14;28;
0223073;"Sobótka (3)";162;86;76;23;36;45;66;
0223074;"Sobótka - miasto (4)";78;34;44;12;19;18;32;
0223075;"Sobótka - obszar wiejski (5)";84;52;32;11;17;27;34;
0223083;"Siechnice (3)";236;131;105;13;46;54;57;
0223084;"Siechnice - miasto (4)";83;49;34;2;17;17;25;
0223085;"Siechnice - obszar wiejski (5)";153;82;71;11;29;37;32;
0223092;"Żórawina (2)";124;72;52;10;25;40;53;
0224000;"Powiat ząbkowicki";2489;1242;1247;317;630;637;1048;
0224013;"Bardo (3)";204;98;106;20;37;62;83;
0224014;"Bardo - miasto (4)";81;38;43;6;13;28;29;
0224015;"Bardo - obszar wiejski (5)";123;60;63;14;24;34;54;
0224022;"Ciepłowody (2)";133;68;65;21;49;31;62;
0224032;"Kamieniec Ząbkowicki (2)";300;152;148;35;68;72;134;
0224042;"Stoszowice (2)";215;104;111;20;47;60;104;
0224053;"Ząbkowice Śląskie (3)";735;349;386;88;184;178;285;
0224054;"Ząbkowice Śląskie - miasto (4)";497;230;267;59;124;126;184;
0224055;"Ząbkowice Śląskie - obszar wiejski (5)";238;119;119;29;60;52;101;
0224063;"Ziębice (3)";666;357;309;105;190;169;266;
0224064;"Ziębice - miasto (4)";331;177;154;43;85;85;129;
0224065;"Ziębice - obszar wiejski (5)";335;180;155;62;105;84;137;
0224073;"Złoty Stok (3)";236;114;122;28;55;65;114;
0224074;"Złoty Stok - miasto (4)";141;76;65;18;28;35;56;
0224075;"Złoty Stok - obszar wiejski (5)";95;38;57;10;27;30;58;
0225000;"Powiat zgorzelecki";1814;942;872;198;421;617;775;
0225011;"Zawidów (1)";94;59;35;8;12;42;23;
0225021;"Zgorzelec (1)";557;259;298;67;123;199;200;
0225033;"Bogatynia (3)";392;218;174;38;97;118;179;
0225034;"Bogatynia - miasto (4)";262;139;123;25;66;75;112;
0225035;"Bogatynia - obszar wiejski (5)";130;79;51;13;31;43;67;
0225043;"Pieńsk (3)";253;120;133;26;60;84;128;
0225044;"Pieńsk - miasto (4)";159;75;84;18;39;55;80;
0225045;"Pieńsk - obszar wiejski (5)";94;45;49;8;21;29;48;
0225052;"Sulików (2)";149;79;70;19;40;58;79;
0225063;"Węgliniec (3)";212;117;95;20;45;75;118;
0225064;"Węgliniec - miasto (4)";60;34;26;7;17;18;33;
0225065;"Węgliniec - obszar wiejski (5)";152;83;69;13;28;57;85;
0225072;"Zgorzelec (2)";157;90;67;20;44;41;48;
0226000;"Powiat złotoryjski";2073;1063;1010;266;536;531;1077;
0226011;"Wojcieszów (1)";207;114;93;26;43;61;114;
0226021;"Złotoryja (1)";571;276;295;66;135;129;253;
0226032;"Pielgrzymka (2)";275;144;131;38;76;72;164;
0226043;"Świerzawa (3)";464;245;219;61;122;128;265;
0226044;"Świerzawa - miasto (4)";123;71;52;21;36;34;82;
0226045;"Świerzawa - obszar wiejski (5)";341;174;167;40;86;94;183;
0226052;"Zagrodno (2)";245;116;129;31;61;71;123;
0226062;"Złotoryja (2)";311;168;143;44;99;70;158;
0261000;"Powiat m.Jelenia Góra";1403;719;684;136;314;405;446;
0261011;"Jelenia Góra (1)";1403;719;684;136;314;405;446;
0262000;"Powiat m.Legnica";2402;1302;1100;195;464;656;1040;
0262011;"Legnica (1)";2402;1302;1100;195;464;656;1040;
0264000;"Powiat m.Wrocław";8790;4327;4463;514;1599;2688;3078;
0264011;"Wrocław (1)";8790;4327;4463;514;1599;2688;3078;
0265000;"Powiat m.Wałbrzych od 2013";2552;1389;1163;244;528;679;818;
0265011;"Wałbrzych od 2013 (1)";2552;1389;1163;244;528;679;818;
0400000;"KUJAWSKO-POMORSKIE";72133;42070;30063;9713;20015;16933;36614;
0401000;"Powiat aleksandrowski";2679;1471;1208;362;710;652;1421;
0401011;"Aleksandrów Kujawski (1)";634;346;288;79;150;144;344;
0401021;"Ciechocinek (1)";429;228;201;35;83;120;221;
0401031;"Nieszawa (1)";126;60;66;19;31;44;76;
0401042;"Aleksandrów Kujawski (2)";639;356;283;95;186;141;315;
0401052;"Bądkowo (2)";125;74;51;19;35;29;62;
0401062;"Koneck (2)";145;74;71;24;48;40;88;
0401072;"Raciążek (2)";164;86;78;25;46;48;89;
0401082;"Waganiec (2)";248;153;95;37;79;47;141;
0401092;"Zakrzewo (2)";169;94;75;29;52;39;85;
0402000;"Powiat brodnicki";2568;1596;972;460;895;501;1113;
0402011;"Brodnica (1)";957;578;379;129;276;195;383;
0402022;"Bobrowo (2)";221;145;76;39;86;32;102;
0402032;"Brodnica (2)";227;138;89;41;81;41;82;
0402042;"Brzozie (2)";98;61;37;13;42;20;39;
0402053;"Górzno (3)";88;56;32;20;38;20;35;
0402054;"Górzno - miasto (4)";21;12;9;2;7;8;10;
0402055;"Górzno - obszar wiejski (5)";67;44;23;18;31;12;25;
0402062;"Bartniczka (2)";141;87;54;30;53;25;66;
0402073;"Jabłonowo Pomorskie (3)";334;223;111;71;124;70;183;
0402074;"Jabłonowo Pomorskie - miasto (4)";131;87;44;24;52;30;74;
0402075;"Jabłonowo Pomorskie - obszar wiejski (5)";203;136;67;47;72;40;109;
0402082;"Osiek (2)";142;86;56;28;49;29;60;
0402092;"Świedziebnia (2)";182;115;67;52;85;31;84;
0402102;"Zbiczno (2)";178;107;71;37;61;38;79;
0403000;"Powiat bydgoski";2077;1225;852;265;574;519;757;
0403012;"Białe Błota (2)";330;193;137;43;94;89;94;
0403022;"Dąbrowa Chełmińska (2)";167;93;74;18;49;43;66;
0403032;"Dobrcz (2)";185;110;75;23;44;47;66;
0403043;"Koronowo (3)";525;316;209;77;164;131;215;
0403044;"Koronowo - miasto (4)";228;137;91;24;71;60;86;
0403045;"Koronowo - obszar wiejski (5)";297;179;118;53;93;71;129;
0403052;"Nowa Wieś Wielka (2)";171;91;80;19;43;33;59;
0403062;"Osielsko (2)";200;124;76;25;47;57;84;
0403072;"Sicienko (2)";229;135;94;33;64;56;79;
0403083;"Solec Kujawski (3)";270;163;107;27;69;63;94;
0403084;"Solec Kujawski - miasto (4)";245;143;102;25;63;60;91;
0403085;"Solec Kujawski - obszar wiejski (5)";25;20;5;2;6;3;3;
0404000;"Powiat chełmiński";2339;1350;989;337;674;547;1255;
0404011;"Chełmno (1)";848;463;385;102;208;215;480;
0404022;"Chełmno (2)";266;171;95;53;107;43;133;
0404032;"Kijewo Królewskie (2)";196;124;72;38;67;36;106;
0404042;"Lisewo (2)";195;100;95;34;63;46;105;
0404052;"Papowo Biskupie (2)";296;180;116;37;76;72;178;
0404062;"Stolno (2)";253;151;102;37;81;55;141;
0404072;"Unisław (2)";285;161;124;36;72;80;112;
0405000;"Powiat golubsko-dobrzyński";2110;1285;825;355;685;463;1083;
0405011;"Golub-Dobrzyń (1)";713;412;301;111;216;174;357;
0405022;"Ciechocin (2)";144;91;53;29;57;29;81;
0405032;"Golub-Dobrzyń (2)";409;263;146;78;147;77;190;
0405043;"Kowalewo Pomorskie (3)";445;278;167;64;126;101;220;
0405044;"Kowalewo Pomorskie - miasto (4)";160;102;58;22;43;46;74;
0405045;"Kowalewo Pomorskie - obszar wiejski (5)";285;176;109;42;83;55;146;
0405052;"Radomin (2)";168;102;66;30;56;37;95;
0405062;"Zbójno (2)";231;139;92;43;83;45;140;
0406000;"Powiat grudziądzki";1846;1115;731;250;532;441;1024;
0406012;"Grudziądz (2)";457;259;198;53;131;115;206;
0406022;"Gruta (2)";261;153;108;48;82;65;144;
0406033;"Łasin (3)";393;232;161;48;109;88;241;
0406034;"Łasin - miasto (4)";144;77;67;20;44;37;77;
0406035;"Łasin - obszar wiejski (5)";249;155;94;28;65;51;164;
0406043;"Radzyń Chełmiński (3)";275;170;105;39;80;76;160;
0406044;"Radzyń Chełmiński - miasto (4)";115;71;44;18;28;31;62;
0406045;"Radzyń Chełmiński - obszar wiejski (5)";160;99;61;21;52;45;98;
0406052;"Rogóźno (2)";217;131;86;31;60;43;126;
0406062;"Świecie nad Osą (2)";243;170;73;31;70;54;147;
0407000;"Powiat inowrocławski";7531;4353;3178;1058;2156;1705;3701;
0407011;"Inowrocław (1)";3386;1894;1492;395;833;858;1667;
0407022;"Dąbrowa Biskupia (2)";246;136;110;47;80;42;123;
0407033;"Gniewkowo (3)";730;395;335;106;209;137;347;
0407034;"Gniewkowo - miasto (4)";364;185;179;52;104;72;168;
0407035;"Gniewkowo - obszar wiejski (5)";366;210;156;54;105;65;179;
0407042;"Inowrocław (2)";523;306;217;90;182;97;248;
0407053;"Janikowo (3)";572;367;205;97;200;135;280;
0407054;"Janikowo - miasto (4)";352;226;126;48;115;89;170;
0407055;"Janikowo - obszar wiejski (5)";220;141;79;49;85;46;110;
0407063;"Kruszwica (3)";913;557;356;148;300;194;469;
0407064;"Kruszwica - miasto (4)";410;248;162;50;120;103;201;
0407065;"Kruszwica - obszar wiejski (5)";503;309;194;98;180;91;268;
0407073;"Pakość (3)";466;291;175;67;138;89;226;
0407074;"Pakość - miasto (4)";264;166;98;30;75;53;124;
0407075;"Pakość - obszar wiejski (5)";202;125;77;37;63;36;102;
0407082;"Rojewo (2)";234;139;95;40;76;47;103;
0407092;"Złotniki Kujawskie (2)";461;268;193;68;138;106;238;
0408000;"Powiat lipnowski";3546;2048;1498;591;1130;685;1987;
0408011;"Lipno (1)";703;394;309;118;208;122;384;
0408022;"Bobrowniki (2)";157;82;75;24;58;34;78;
0408032;"Chrostkowo (2)";120;70;50;31;45;22;65;
0408043;"Dobrzyń nad Wisłą (3)";510;268;242;64;140;127;334;
0408044;"Dobrzyń nad Wisłą - miasto (4)";157;78;79;17;35;45;99;
0408045;"Dobrzyń nad Wisłą - obszar wiejski (5)";353;190;163;47;105;82;235;
0408052;"Kikół (2)";384;242;142;60;122;87;219;
0408062;"Lipno (2)";659;387;272;114;219;119;341;
0408073;"Skępe (3)";434;249;185;78;140;88;231;
0408074;"Skępe - miasto (4)";178;105;73;27;51;34;85;
0408075;"Skępe - obszar wiejski (5)";256;144;112;51;89;54;146;
0408082;"Tłuchowo (2)";208;140;68;37;68;27;118;
0408092;"Wielgie (2)";371;216;155;65;130;59;217;
0409000;"Powiat mogileński";1835;1182;653;318;622;354;934;
0409012;"Dąbrowa (2)";175;124;51;41;76;27;89;
0409022;"Jeziora Wielkie (2)";214;114;100;30;75;42;123;
0409033;"Mogilno (3)";917;595;322;173;309;180;448;
0409034;"Mogilno - miasto (4)";408;263;145;69;118;93;203;
0409035;"Mogilno - obszar wiejski (5)";509;332;177;104;191;87;245;
0409043;"Strzelno (3)";529;349;180;74;162;105;274;
0409044;"Strzelno - miasto (4)";257;169;88;32;70;55;123;
0409045;"Strzelno - obszar wiejski (5)";272;180;92;42;92;50;151;
0410000;"Powiat nakielski";3550;2200;1350;564;1119;771;1700;
0410013;"Kcynia (3)";552;327;225;107;192;123;288;
0410014;"Kcynia - miasto (4)";198;106;92;33;57;52;90;
0410015;"Kcynia - obszar wiejski (5)";354;221;133;74;135;71;198;
0410023;"Mrocza (3)";504;322;182;70;145;118;265;
0410024;"Mrocza - miasto (4)";195;120;75;19;54;49;97;
0410025;"Mrocza - obszar wiejski (5)";309;202;107;51;91;69;168;
0410033;"Nakło nad Notecią (3)";1364;880;484;193;400;288;683;
0410034;"Nakło nad Notecią - miasto (4)";829;528;301;123;246;182;411;
0410035;"Nakło nad Notecią - obszar wiejski (5)";535;352;183;70;154;106;272;
0410042;"Sadki (2)";298;211;87;60;106;56;147;
0410053;"Szubin (3)";832;460;372;134;276;186;317;
0410054;"Szubin - miasto (4)";340;182;158;54;117;74;128;
0410055;"Szubin - obszar wiejski (5)";492;278;214;80;159;112;189;
0411000;"Powiat radziejowski";2568;1509;1059;375;749;551;1692;
0411011;"Radziejów (1)";363;190;173;41;86;83;218;
0411022;"Bytoń (2)";180;101;79;35;60;35;116;
0411032;"Dobre (2)";415;245;170;49;105;104;277;
0411042;"Osięciny (2)";528;325;203;76;159;113;394;
0411053;"Piotrków Kujawski (3)";633;384;249;112;207;123;396;
0411054;"Piotrków Kujawski - miasto (4)";306;187;119;38;82;63;184;
0411055;"Piotrków Kujawski - obszar wiejski (5)";327;197;130;74;125;60;212;
0411062;"Radziejów (2)";201;131;70;29;62;36;130;
0411072;"Topólka (2)";248;133;115;33;70;57;161;
0412000;"Powiat rypiński";1684;1077;607;285;547;349;869;
0412011;"Rypin (1)";693;440;253;98;201;156;372;
0412022;"Brzuze (2)";218;141;77;38;74;49;120;
0412032;"Rogowo (2)";161;106;55;34;76;23;80;
0412042;"Rypin (2)";252;151;101;42;71;55;110;
0412052;"Skrwilno (2)";226;154;72;46;75;36;122;
0412062;"Wąpielsk (2)";134;85;49;27;50;30;65;
0413000;"Powiat sępoleński";1848;1080;768;296;568;414;943;
0413013;"Kamień Krajeński (3)";318;190;128;50;96;76;162;
0413014;"Kamień Krajeński - miasto (4)";108;71;37;15;33;29;51;
0413015;"Kamień Krajeński - obszar wiejski (5)";210;119;91;35;63;47;111;
0413023;"Sępólno Krajeńskie (3)";758;432;326;109;215;179;365;
0413024;"Sępólno Krajeńskie - miasto (4)";413;223;190;64;122;99;182;
0413025;"Sępólno Krajeńskie - obszar wiejski (5)";345;209;136;45;93;80;183;
0413032;"Sośno (2)";257;142;115;45;84;54;133;
0413043;"Więcbork (3)";515;316;199;92;173;105;283;
0413044;"Więcbork - miasto (4)";226;139;87;36;67;51;130;
0413045;"Więcbork - obszar wiejski (5)";289;177;112;56;106;54;153;
0414000;"Powiat świecki";2680;1607;1073;425;821;664;1243;
0414012;"Bukowiec (2)";132;89;43;22;51;20;62;
0414022;"Dragacz (2)";174;108;66;21;44;46;100;
0414032;"Drzycim (2)";110;63;47;17;32;28;47;
0414042;"Jeżewo (2)";196;113;83;34;81;43;90;
0414052;"Lniano (2)";89;45;44;17;31;19;30;
0414063;"Nowe (3)";516;297;219;67;137;152;293;
0414064;"Nowe - miasto (4)";253;142;111;37;64;77;129;
0414065;"Nowe - obszar wiejski (5)";263;155;108;30;73;75;164;
0414072;"Osie (2)";114;78;36;22;45;25;51;
0414082;"Pruszcz (2)";230;128;102;37;71;63;92;
0414093;"Świecie (3)";796;489;307;141;234;179;321;
0414094;"Świecie - miasto (4)";550;327;223;86;155;125;218;
0414095;"Świecie - obszar wiejski (5)";246;162;84;55;79;54;103;
0414102;"Świekatowo (2)";75;40;35;15;25;17;28;
0414112;"Warlubie (2)";248;157;91;32;70;72;129;
0415000;"Powiat toruński";3764;2304;1460;535;1173;704;1677;
0415011;"Chełmża (1)";771;461;310;114;233;173;344;
0415022;"Chełmża (2)";347;212;135;59;122;58;141;
0415032;"Czernikowo (2)";453;277;176;57;126;96;269;
0415042;"Lubicz (2)";586;352;234;75;164;121;252;
0415052;"Łubianka (2)";199;122;77;39;81;27;68;
0415062;"Łysomice (2)";271;171;100;37;94;38;91;
0415072;"Obrowo (2)";587;392;195;73;168;95;280;
0415082;"Wielka Nieszawka (2)";137;80;57;9;36;27;58;
0415092;"Zławieś Wielka (2)";413;237;176;72;149;69;174;
0416000;"Powiat tucholski";2039;1147;892;340;674;441;999;
0416012;"Cekcyn (2)";257;159;98;39;79;51;123;
0416022;"Gostycyn (2)";201;116;85;26;62;42;96;
0416032;"Kęsowo (2)";217;124;93;36;68;65;116;
0416042;"Lubiewo (2)";182;110;72;41;75;30;88;
0416052;"Śliwice (2)";254;126;128;44;97;48;104;
0416063;"Tuchola (3)";928;512;416;154;293;205;472;
0416064;"Tuchola - miasto (4)";612;334;278;94;187;141;306;
0416065;"Tuchola - obszar wiejski (5)";316;178;138;60;106;64;166;
0417000;"Powiat wąbrzeski";1734;1031;703;286;539;383;993;
0417011;"Wąbrzeźno (1)";702;411;291;122;206;168;386;
0417022;"Dębowa Łąka (2)";169;110;59;34;61;28;91;
0417032;"Książki (2)";177;101;76;25;50;37;113;
0417042;"Płużnica (2)";238;133;105;29;66;58;152;
0417052;"Ryńsk (2)";448;276;172;76;156;92;251;
0418000;"Powiat włocławski";4999;2861;2138;574;1235;1274;3312;
0418011;"Kowal (1)";173;91;82;17;45;50;93;
0418022;"Baruchowo (2)";188;121;67;27;53;47;118;
0418032;"Boniewo (2)";298;160;138;39;81;68;218;
0418043;"Brześć Kujawski (3)";579;334;245;61;129;167;397;
0418044;"Brześć Kujawski - miasto (4)";273;162;111;23;45;78;188;
0418045;"Brześć Kujawski - obszar wiejski (5)";306;172;134;38;84;89;209;
0418052;"Choceń (2)";544;320;224;60;118;139;377;
0418063;"Chodecz (3)";379;228;151;34;79;104;291;
0418064;"Chodecz - miasto (4)";96;54;42;5;14;35;78;
0418065;"Chodecz - obszar wiejski (5)";283;174;109;29;65;69;213;
0418072;"Fabianki (2)";430;258;172;50;109;93;242;
0418083;"Izbica Kujawska (3)";518;288;230;69;147;105;328;
0418084;"Izbica Kujawska - miasto (4)";186;104;82;19;50;42;120;
0418085;"Izbica Kujawska - obszar wiejski (5)";332;184;148;50;97;63;208;
0418092;"Kowal (2)";177;99;78;20;46;53;109;
0418102;"Lubanie (2)";174;114;60;14;32;51;121;
0418113;"Lubień Kujawski (3)";503;292;211;68;140;124;339;
0418114;"Lubień Kujawski - miasto (4)";105;65;40;16;25;31;60;
0418115;"Lubień Kujawski - obszar wiejski (5)";398;227;171;52;115;93;279;
0418123;"Lubraniec (3)";661;340;321;76;167;170;438;
0418124;"Lubraniec - miasto (4)";212;113;99;19;43;60;136;
0418125;"Lubraniec - obszar wiejski (5)";449;227;222;57;124;110;302;
0418132;"Włocławek (2)";375;216;159;39;89;103;241;
0419000;"Powiat żniński";2544;1627;917;364;703;571;1216;
0419013;"Barcin (3)";494;296;198;69;137;110;228;
0419014;"Barcin - miasto (4)";231;124;107;33;68;48;101;
0419015;"Barcin - obszar wiejski (5)";263;172;91;36;69;62;127;
0419022;"Gąsawa (2)";238;154;84;37;76;54;136;
0419033;"Janowiec Wielkopolski (3)";404;278;126;60;106;93;223;
0419034;"Janowiec Wielkopolski - miasto (4)";165;116;49;20;37;42;93;
0419035;"Janowiec Wielkopolski - obszar wiejski (5)";239;162;77;40;69;51;130;
0419043;"Łabiszyn (3)";368;230;138;42;88;80;180;
0419044;"Łabiszyn - miasto (4)";161;99;62;12;36;39;78;
0419045;"Łabiszyn - obszar wiejski (5)";207;131;76;30;52;41;102;
0419052;"Rogowo (2)";262;172;90;41;75;61;125;
0419063;"Żnin (3)";778;497;281;115;221;173;324;
0419064;"Żnin - miasto (4)";409;248;161;48;103;102;164;
0419065;"Żnin - obszar wiejski (5)";369;249;120;67;118;71;160;
0461000;"Powiat m.Bydgoszcz";5424;2960;2464;445;1144;1499;2081;
0461011;"Bydgoszcz (1)";5424;2960;2464;445;1144;1499;2081;
0462000;"Powiat m.Grudziądz";3642;2041;1601;429;878;1005;1755;
0462011;"Grudziądz (1)";3642;2041;1601;429;878;1005;1755;
0463000;"Powiat m.Toruń";4286;2393;1893;386;949;1014;1949;
0463011;"Toruń (1)";4286;2393;1893;386;949;1014;1949;
0464000;"Powiat m.Włocławek";4840;2608;2232;413;938;1426;2910;
0464011;"Włocławek (1)";4840;2608;2232;413;938;1426;2910;
0600000;"LUBELSKIE";75733;38665;37068;10786;23239;16820;40774;
0601000;"Powiat bialski";4608;2272;2336;662;1453;979;2647;
0601011;"Międzyrzec Podlaski (1)";819;387;432;94;234;200;444;
0601021;"Terespol (1)";250;127;123;23;55;61;127;
0601032;"Biała Podlaska (2)";606;290;316;91;196;119;355;
0601042;"Drelów (2)";166;82;84;24;54;34;95;
0601052;"Janów Podlaski (2)";240;111;129;37;66;54;148;
0601062;"Kodeń (2)";141;82;59;19;41;43;82;
0601072;"Konstantynów (2)";164;83;81;24;56;28;104;
0601082;"Leśna Podlaska (2)";158;71;87;25;57;34;101;
0601092;"Łomazy (2)";173;75;98;27;66;28;89;
0601102;"Międzyrzec Podlaski (2)";364;194;170;87;161;55;183;
0601112;"Piszczac (2)";323;167;156;35;91;79;191;
0601122;"Rokitno (2)";139;61;78;21;40;26;84;
0601132;"Rossosz (2)";79;37;42;15;30;13;49;
0601142;"Sławatycze (2)";115;54;61;21;36;18;70;
0601152;"Sosnówka (2)";65;27;38;7;25;6;48;
0601162;"Terespol (2)";290;162;128;30;69;75;162;
0601172;"Tuczna (2)";105;52;53;25;47;20;64;
0601182;"Wisznice (2)";189;83;106;25;53;41;127;
0601192;"Zalesie (2)";222;127;95;32;76;45;124;
0602000;"Powiat biłgorajski";2659;1340;1319;464;977;498;1085;
0602011;"Biłgoraj (1)";781;394;387;79;191;136;320;
0602022;"Aleksandrów (2)";78;44;34;26;43;13;39;
0602032;"Biłgoraj (2)";441;212;229;68;155;105;171;
0602042;"Biszcza (2)";110;60;50;20;45;18;50;
0602053;"Frampol (3)";154;66;88;31;72;41;67;
0602054;"Frampol - miasto (4)";43;15;28;2;18;13;16;
0602055;"Frampol - obszar wiejski (5)";111;51;60;29;54;28;51;
0602062;"Goraj (2)";100;52;48;22;42;13;41;
0602073;"Józefów (3)";204;119;85;45;75;35;82;
0602074;"Józefów - miasto (4)";80;39;41;17;30;11;27;
0602075;"Józefów - obszar wiejski (5)";124;80;44;28;45;24;55;
0602082;"Księżpol (2)";178;94;84;35;77;30;69;
0602092;"Łukowa (2)";65;36;29;16;38;10;20;
0602102;"Obsza (2)";80;39;41;30;51;9;30;
0602112;"Potok Górny (2)";101;44;57;21;42;18;35;
0602123;"Tarnogród (3)";126;64;62;27;45;26;51;
0602124;"Tarnogród - miasto (4)";72;37;35;9;15;16;31;
0602125;"Tarnogród - obszar wiejski (5)";54;27;27;18;30;10;20;
0602132;"Tereszpol (2)";107;45;62;20;45;25;41;
0602142;"Turobin (2)";134;71;63;24;56;19;69;
0603000;"Powiat chełmski";3623;2015;1608;525;1132;836;2110;
0603011;"Rejowiec Fabryczny (1)";187;105;82;17;49;52;94;
0603022;"Białopole (2)";111;72;39;17;41;15;69;
0603032;"Chełm (2)";578;310;268;85;196;125;309;
0603042;"Dorohusk (2)";357;212;145;37;92;90;214;
0603052;"Dubienka (2)";109;44;65;13;33;22;67;
0603062;"Kamień (2)";194;112;82;39;70;38;109;
0603072;"Leśniowice (2)";173;103;70;28;58;26;107;
0603082;"Rejowiec Fabryczny (2)";257;139;118;31;67;67;160;
0603092;"Ruda-Huta (2)";255;133;122;35;72;63;152;
0603102;"Sawin (2)";259;145;114;34;86;57;119;
0603113;"Siedliszcze (3)";260;146;114;51;95;67;155;
0603114;"Siedliszcze - miasto (4)";44;24;20;5;11;15;27;
0603115;"Siedliszcze - obszar wiejski (5)";216;122;94;46;84;52;128;
0603122;"Wierzbica (2)";219;130;89;34;70;52;140;
0603132;"Wojsławice (2)";169;97;72;40;73;28;106;
0603142;"Żmudź (2)";132;72;60;28;47;19;75;
0603153;"Rejowiec (3)";363;195;168;36;83;115;234;
0603154;"Rejowiec - miasto (4)";123;72;51;7;29;34;75;
0603155;"Rejowiec - obszar wiejski (5)";240;123;117;29;54;81;159;
0604000;"Powiat hrubieszowski";3503;1794;1709;540;1115;755;2241;
0604011;"Hrubieszów (1)";971;489;482;118;244;205;560;
0604022;"Dołhobyczów (2)";316;175;141;44;86;89;233;
0604032;"Horodło (2)";400;189;211;47;110;111;280;
0604042;"Hrubieszów (2)";570;300;270;111;219;114;369;
0604052;"Mircze (2)";284;146;138;60;114;47;160;
0604062;"Trzeszczany (2)";232;127;105;37;83;46;155;
0604072;"Uchanie (2)";234;110;124;40;84;44;157;
0604082;"Werbkowice (2)";496;258;238;83;175;99;327;
0605000;"Powiat janowski";2194;1027;1167;446;895;412;1322;
0605012;"Batorz (2)";151;68;83;43;80;20;87;
0605022;"Chrzanów (2)";85;39;46;30;56;6;51;
0605032;"Dzwola (2)";321;138;183;68;121;61;213;
0605042;"Godziszów (2)";221;91;130;82;146;11;122;
0605053;"Janów Lubelski (3)";867;425;442;111;267;198;515;
0605054;"Janów Lubelski - miasto (4)";616;304;312;74;185;141;366;
0605055;"Janów Lubelski - obszar wiejski (5)";251;121;130;37;82;57;149;
0605063;"Modliborzyce (3)";353;173;180;68;144;71;216;
0605064;"Modliborzyce - miasto (4)";75;37;38;11;29;19;42;
0605065;"Modliborzyce - obszar wiejski (5)";278;136;142;57;115;52;174;
0605072;"Potok Wielki (2)";196;93;103;44;81;45;118;
0606000;"Powiat krasnostawski";3275;1599;1676;494;1051;703;2099;
0606011;"Krasnystaw (1)";840;407;433;76;206;211;497;
0606022;"Fajsławice (2)";176;74;102;31;62;34;114;
0606032;"Gorzków (2)";144;72;72;29;51;13;89;
0606042;"Izbica (2)";578;283;295;86;173;125;402;
0606052;"Krasnystaw (2)";481;247;234;86;172;86;303;
0606062;"Kraśniczyn (2)";219;103;116;28;69;55;156;
0606072;"Łopiennik Górny (2)";202;101;101;38;73;47;132;
0606092;"Rudnik (2)";176;73;103;35;65;31;113;
0606102;"Siennica Różana (2)";221;117;104;35;82;53;139;
0606112;"Żółkiewka (2)";238;122;116;50;98;48;154;
0607000;"Powiat kraśnicki";4572;2149;2423;783;1535;895;2777;
0607011;"Kraśnik (1)";1625;766;859;185;378;361;947;
0607023;"Annopol (3)";496;237;259;94;182;102;335;
0607024;"Annopol - miasto (4)";149;72;77;23;45;35;87;
0607025;"Annopol - obszar wiejski (5)";347;165;182;71;137;67;248;
0607032;"Dzierzkowice (2)";274;126;148;50;109;49;166;
0607042;"Gościeradów (2)";405;184;221;92;164;79;247;
0607052;"Kraśnik (2)";469;230;239;74;163;84;287;
0607062;"Szastarka (2)";250;127;123;59;116;43;162;
0607072;"Trzydnik Duży (2)";230;111;119;60;94;43;125;
0607083;"Urzędów (3)";374;168;206;74;148;58;236;
0607084;"Urzędów - miasto (4)";74;32;42;13;32;13;45;
0607085;"Urzędów - obszar wiejski (5)";300;136;164;61;116;45;191;
0607092;"Wilkołaz (2)";186;86;100;38;74;28;104;
0607102;"Zakrzówek (2)";263;114;149;57;107;48;168;
0608000;"Powiat lubartowski";4077;2156;1921;550;1220;938;2449;
0608011;"Lubartów (1)";927;461;466;82;204;246;521;
0608022;"Abramów (2)";127;63;64;25;54;28;77;
0608032;"Firlej (2)";326;176;150;47;105;70;223;
0608042;"Jeziorzany (2)";149;82;67;21;48;34;92;
0608052;"Kamionka (2)";292;181;111;49;99;64;167;
0608063;"Kock (3)";411;206;205;42;109;119;286;
0608064;"Kock - miasto (4)";219;106;113;19;48;74;151;
0608065;"Kock - obszar wiejski (5)";192;100;92;23;61;45;135;
0608072;"Lubartów (2)";500;265;235;55;123;112;268;
0608082;"Michów (2)";297;170;127;54;110;57;193;
0608092;"Niedźwiada (2)";305;165;140;49;103;63;174;
0608103;"Ostrów Lubelski (3)";161;89;72;27;63;23;97;
0608104;"Ostrów Lubelski - miasto (4)";59;29;30;7;18;10;33;
0608105;"Ostrów Lubelski - obszar wiejski (5)";102;60;42;20;45;13;64;
0608112;"Ostrówek (2)";204;104;100;38;69;38;124;
0608122;"Serniki (2)";246;131;115;46;88;52;146;
0608132;"Uścimów (2)";132;63;69;15;45;32;81;
0609000;"Powiat lubelski";3681;1912;1769;652;1331;719;1639;
0609013;"Bełżyce (3)";476;239;237;76;153;103;238;
0609014;"Bełżyce - miasto (4)";233;125;108;34;69;50;107;
0609015;"Bełżyce - obszar wiejski (5)";243;114;129;42;84;53;131;
0609022;"Borzechów (2)";99;45;54;21;45;16;48;
0609033;"Bychawa (3)";321;164;157;71;131;60;166;
0609034;"Bychawa - miasto (4)";138;70;68;25;52;35;70;
0609035;"Bychawa - obszar wiejski (5)";183;94;89;46;79;25;96;
0609042;"Garbów (2)";160;87;73;32;69;37;68;
0609052;"Głusk (2)";180;94;86;34;65;38;51;
0609062;"Jabłonna (2)";221;120;101;37;79;41;101;
0609072;"Jastków (2)";268;137;131;49;97;47;95;
0609082;"Konopnica (2)";243;137;106;43;97;47;73;
0609092;"Krzczonów (2)";99;49;50;18;29;22;55;
0609102;"Niedrzwica Duża (2)";356;172;184;58;122;69;172;
0609112;"Niemce (2)";376;211;165;70;134;61;143;
0609122;"Strzyżewice (2)";233;120;113;37;84;58;124;
0609132;"Wojciechów (2)";162;80;82;22;42;41;101;
0609142;"Wólka (2)";264;141;123;42;85;44;73;
0609152;"Wysokie (2)";136;73;63;26;62;23;76;
0609162;"Zakrzew (2)";87;43;44;16;37;12;55;
0610000;"Powiat łęczyński";1600;897;703;299;592;280;718;
0610012;"Cyców (2)";236;129;107;54;105;48;109;
0610022;"Ludwin (2)";160;81;79;35;73;23;77;
0610033;"Łęczna (3)";600;348;252;103;209;92;241;
0610034;"Łęczna - miasto (4)";478;281;197;71;161;82;192;
0610035;"Łęczna - obszar wiejski (5)";122;67;55;32;48;10;49;
0610042;"Milejów (2)";263;147;116;47;88;55;131;
0610052;"Puchaczów (2)";144;83;61;30;53;23;73;
0610062;"Spiczyn (2)";197;109;88;30;64;39;87;
0611000;"Powiat łukowski";2314;1273;1041;433;828;476;893;
0611011;"Łuków (1)";687;359;328;99;186;155;256;
0611021;"Stoczek Łukowski (1)";60;33;27;9;19;9;31;
0611032;"Adamów (2)";131;65;66;26;49;25;50;
0611042;"Krzywda (2)";253;154;99;51;101;49;105;
0611052;"Łuków (2)";408;245;163;76;155;77;156;
0611062;"Serokomla (2)";92;45;47;25;51;13;33;
0611072;"Stanin (2)";185;101;84;45;77;43;78;
0611082;"Stoczek Łukowski (2)";103;51;52;17;37;23;41;
0611092;"Trzebieszów (2)";135;80;55;29;45;40;39;
0611102;"Wojcieszków (2)";177;96;81;41;74;30;62;
0611112;"Wola Mysłowska (2)";83;44;39;15;34;12;42;
0612000;"Powiat opolski";2424;1201;1223;436;819;522;1376;
0612012;"Chodel (2)";251;135;116;47;102;40;117;
0612023;"Józefów nad Wisłą (3)";265;130;135;51;99;51;172;
0612024;"Józefów nad Wisłą - miasto (4)";42;20;22;4;8;13;26;
0612025;"Józefów nad Wisłą - obszar wiejski (5)";223;110;113;47;91;38;146;
0612032;"Karczmiska (2)";247;112;135;42;89;54;139;
0612042;"Łaziska (2)";185;95;90;43;71;35;110;
0612053;"Opole Lubelskie (3)";681;323;358;124;222;174;384;
0612054;"Opole Lubelskie - miasto (4)";337;155;182;52;99;91;179;
0612055;"Opole Lubelskie - obszar wiejski (5)";344;168;176;72;123;83;205;
0612063;"Poniatowa (3)";646;326;320;88;175;143;368;
0612064;"Poniatowa - miasto (4)";414;209;205;47;98;97;228;
0612065;"Poniatowa - obszar wiejski (5)";232;117;115;41;77;46;140;
0612072;"Wilków (2)";149;80;69;41;61;25;86;
0613000;"Powiat parczewski";1042;590;452;138;315;229;561;
0613012;"Dębowa Kłoda (2)";148;93;55;14;45;27;98;
0613022;"Jabłoń (2)";100;47;53;20;39;21;55;
0613032;"Milanów (2)";103;57;46;9;26;27;70;
0613043;"Parczew (3)";428;238;190;57;124;102;194;
0613044;"Parczew - miasto (4)";311;173;138;31;85;75;142;
0613045;"Parczew - obszar wiejski (5)";117;65;52;26;39;27;52;
0613052;"Podedwórze (2)";53;26;27;8;20;13;29;
0613062;"Siemień (2)";127;74;53;25;43;17;64;
0613072;"Sosnowica (2)";83;55;28;5;18;22;51;
0614000;"Powiat puławski";3003;1581;1422;441;921;733;1323;
0614011;"Puławy (1)";1310;701;609;170;374;332;579;
0614022;"Baranów (2)";98;53;45;18;37;25;53;
0614032;"Janowiec (2)";105;56;49;20;38;21;47;
0614043;"Kazimierz Dolny (3)";164;83;81;21;50;37;69;
0614044;"Kazimierz Dolny - miasto (4)";68;36;32;10;20;17;28;
0614045;"Kazimierz Dolny - obszar wiejski (5)";96;47;49;11;30;20;41;
0614052;"Końskowola (2)";187;91;96;35;61;42;76;
0614062;"Kurów (2)";208;114;94;27;51;58;102;
0614072;"Markuszów (2)";64;29;35;5;18;15;35;
0614083;"Nałęczów (3)";219;106;113;28;62;59;94;
0614084;"Nałęczów - miasto (4)";86;41;45;11;23;30;36;
0614085;"Nałęczów - obszar wiejski (5)";133;65;68;17;39;29;58;
0614092;"Puławy (2)";333;190;143;59;118;79;140;
0614102;"Wąwolnica (2)";132;66;66;16;42;26;59;
0614112;"Żyrzyn (2)";183;92;91;42;70;39;69;
0615000;"Powiat radzyński";1659;797;862;290;586;352;843;
0615011;"Radzyń Podlaski (1)";457;215;242;47;105;108;213;
0615022;"Borki (2)";179;94;85;33;76;30;92;
0615032;"Czemierniki (2)";144;72;72;32;63;27;79;
0615042;"Kąkolewnica (2)";189;98;91;39;75;32;91;
0615052;"Komarówka Podlaska (2)";92;34;58;14;32;26;62;
0615062;"Radzyń Podlaski (2)";242;113;129;47;86;53;126;
0615072;"Ulan-Majorat (2)";149;72;77;35;76;25;70;
0615082;"Wohyń (2)";207;99;108;43;73;51;110;
0616000;"Powiat rycki";1783;942;841;327;634;384;917;
0616011;"Dęblin (1)";514;278;236;71;165;130;269;
0616022;"Kłoczew (2)";207;104;103;46;88;41;96;
0616032;"Nowodwór (2)";147;85;62;35;57;22;77;
0616043;"Ryki (3)";663;334;329;127;234;136;344;
0616044;"Ryki - miasto (4)";276;137;139;44;83;67;157;
0616045;"Ryki - obszar wiejski (5)";387;197;190;83;151;69;187;
0616052;"Stężyca (2)";148;79;69;30;61;27;73;
0616062;"Ułęż (2)";104;62;42;18;29;28;58;
0617000;"Powiat świdnicki";2513;1302;1211;296;649;558;1343;
0617011;"Świdnik (1)";1275;660;615;118;278;286;641;
0617022;"Mełgiew (2)";350;179;171;49;107;71;191;
0617033;"Piaski (3)";395;219;176;66;131;80;221;
0617034;"Piaski - miasto (4)";91;43;48;15;26;18;48;
0617035;"Piaski - obszar wiejski (5)";304;176;128;51;105;62;173;
0617042;"Rybczewice (2)";95;50;45;19;35;15;59;
0617052;"Trawniki (2)";398;194;204;44;98;106;231;
0618000;"Powiat tomaszowski";2563;1415;1148;373;812;604;1289;
0618011;"Tomaszów Lubelski (1)";537;270;267;58;138;133;239;
0618022;"Bełżec (2)";106;64;42;7;24;19;49;
0618032;"Jarczów (2)";81;53;28;22;42;13;45;
0618042;"Krynice (2)";78;46;32;7;23;17;38;
0618053;"Lubycza Królewska (3)";312;181;131;49;101;79;164;
0618054;"Lubycza Królewska - miasto (4)";89;50;39;17;31;24;46;
0618055;"Lubycza Królewska - obszar wiejski (5)";223;131;92;32;70;55;118;
0618063;"Łaszczów (3)";157;82;75;24;54;36;80;
0618064;"Łaszczów - miasto (4)";41;18;23;4;11;8;19;
0618065;"Łaszczów - obszar wiejski (5)";116;64;52;20;43;28;61;
0618072;"Rachanie (2)";192;102;90;30;54;62;105;
0618082;"Susiec (2)";186;92;94;35;65;44;88;
0618092;"Tarnawatka (2)";153;99;54;29;50;40;83;
0618102;"Telatyn (2)";96;65;31;15;38;22;64;
0618112;"Tomaszów Lubelski (2)";332;192;140;48;114;63;147;
0618123;"Tyszowce (3)";118;52;66;15;42;23;59;
0618124;"Tyszowce - miasto (4)";48;20;28;4;21;9;20;
0618125;"Tyszowce - obszar wiejski (5)";70;32;38;11;21;14;39;
0618132;"Ulhówek (2)";215;117;98;34;67;53;128;
0619000;"Powiat włodawski";2214;1200;1014;292;624;502;1361;
0619011;"Włodawa (1)";690;342;348;72;154;177;400;
0619022;"Hanna (2)";131;70;61;24;44;26;86;
0619032;"Hańsk (2)";227;137;90;46;82;47;133;
0619042;"Stary Brus (2)";139;87;52;19;42;31;102;
0619052;"Urszulin (2)";183;110;73;26;63;31;119;
0619062;"Włodawa (2)";397;223;174;51;112;70;237;
0619072;"Wola Uhruska (2)";287;146;141;37;87;74;182;
0619082;"Wyryki (2)";160;85;75;17;40;46;102;
0620000;"Powiat zamojski";4032;2097;1935;660;1402;864;2105;
0620012;"Adamów (2)";167;79;88;21;49;42;78;
0620022;"Grabowiec (2)";205;104;101;47;85;30;116;
0620032;"Komarów-Osada (2)";219;115;104;30;80;36;127;
0620043;"Krasnobród (3)";286;148;138;41;95;62;142;
0620044;"Krasnobród - miasto (4)";122;62;60;17;37;24;58;
0620045;"Krasnobród - obszar wiejski (5)";164;86;78;24;58;38;84;
0620052;"Łabunie (2)";262;152;110;48;95;60;142;
0620062;"Miączyn (2)";225;116;109;41;75;54;120;
0620072;"Nielisz (2)";161;75;86;33;64;33;72;
0620082;"Radecznica (2)";117;61;56;26;45;28;61;
0620092;"Sitno (2)";279;152;127;61;112;46;146;
0620102;"Skierbieszów (2)";207;98;109;46;79;43;112;
0620112;"Stary Zamość (2)";214;112;102;40;89;41;128;
0620122;"Sułów (2)";176;86;90;36;63;43;99;
0620133;"Szczebrzeszyn (3)";454;228;226;59;133;107;244;
0620134;"Szczebrzeszyn - miasto (4)";228;117;111;23;60;56;110;
0620135;"Szczebrzeszyn - obszar wiejski (5)";226;111;115;36;73;51;134;
0620142;"Zamość (2)";781;438;343;98;255;156;364;
0620153;"Zwierzyniec (3)";279;133;146;33;83;83;154;
0620154;"Zwierzyniec - miasto (4)";121;62;59;14;29;36;68;
0620155;"Zwierzyniec - obszar wiejski (5)";158;71;87;19;54;47;86;
0661000;"Powiat m.Biała Podlaska";2679;1291;1388;250;634;622;1522;
0661011;"Biała Podlaska (1)";2679;1291;1388;250;634;622;1522;
0662000;"Powiat m.Chełm";2617;1409;1208;234;607;665;1375;
0662011;"Chełm (1)";2617;1409;1208;234;607;665;1375;
0663000;"Powiat m.Lublin";10365;5059;5306;959;2480;2550;5306;
0663011;"Lublin (1)";10365;5059;5306;959;2480;2550;5306;
0664000;"Powiat m.Zamość";2733;1347;1386;242;627;744;1473;
0664011;"Zamość (1)";2733;1347;1386;242;627;744;1473;
0800000;"LUBUSKIE";23529;13224;10305;2905;6210;5925;8330;
0801000;"Powiat gorzowski";1298;791;507;183;372;332;377;
0801011;"Kostrzyn nad Odrą (1)";208;124;84;28;60;45;49;
0801022;"Bogdaniec (2)";89;62;27;16;33;22;20;
0801032;"Deszczno (2)";178;104;74;23;45;48;42;
0801042;"Kłodawa (2)";116;70;46;16;33;29;22;
0801052;"Lubiszyn (2)";152;88;64;22;39;48;57;
0801062;"Santok (2)";196;122;74;32;61;58;63;
0801073;"Witnica (3)";359;221;138;46;101;82;124;
0801074;"Witnica - miasto (4)";201;115;86;22;54;41;72;
0801075;"Witnica - obszar wiejski (5)";158;106;52;24;47;41;52;
0802000;"Powiat krośnieński";1697;967;730;223;475;418;683;
0802011;"Gubin (1)";600;308;292;62;134;172;267;
0802022;"Bobrowice (2)";83;51;32;17;32;17;30;
0802032;"Bytnica (2)";65;46;19;11;21;14;33;
0802042;"Dąbie (2)";151;100;51;26;47;27;47;
0802052;"Gubin (2)";307;179;128;44;80;82;160;
0802063;"Krosno Odrzańskie (3)";420;246;174;50;135;93;125;
0802064;"Krosno Odrzańskie - miasto (4)";244;146;98;34;84;45;63;
0802065;"Krosno Odrzańskie - obszar wiejski (5)";176;100;76;16;51;48;62;
0802072;"Maszewo (2)";71;37;34;13;26;13;21;
0803000;"Powiat międzyrzecki";1907;1050;857;215;500;511;878;
0803012;"Bledzew (2)";185;107;78;25;46;40;102;
0803023;"Międzyrzecz (3)";693;369;324;77;172;187;281;
0803024;"Międzyrzecz - miasto (4)";442;233;209;50;106;127;173;
0803025;"Międzyrzecz - obszar wiejski (5)";251;136;115;27;66;60;108;
0803032;"Przytoczna (2)";211;111;100;29;61;63;118;
0803042;"Pszczew (2)";110;71;39;8;29;29;45;
0803053;"Skwierzyna (3)";538;309;229;58;150;135;261;
0803054;"Skwierzyna - miasto (4)";400;233;167;46;116;96;180;
0803055;"Skwierzyna - obszar wiejski (5)";138;76;62;12;34;39;81;
0803063;"Trzciel (3)";170;83;87;18;42;57;71;
0803064;"Trzciel - miasto (4)";34;21;13;3;9;11;16;
0803065;"Trzciel - obszar wiejski (5)";136;62;74;15;33;46;55;
0804000;"Powiat nowosolski";2152;1253;899;251;548;539;830;
0804011;"Nowa Sól (1)";847;443;404;91;196;229;267;
0804023;"Bytom Odrzański (3)";121;78;43;16;37;27;42;
0804024;"Bytom Odrzański - miasto (4)";85;53;32;13;27;20;27;
0804025;"Bytom Odrzański - obszar wiejski (5)";36;25;11;3;10;7;15;
0804032;"Kolsko (2)";95;55;40;6;17;36;52;
0804043;"Kożuchów (3)";469;279;190;61;135;111;226;
0804044;"Kożuchów - miasto (4)";247;148;99;36;80;45;98;
0804045;"Kożuchów - obszar wiejski (5)";222;131;91;25;55;66;128;
0804052;"Nowa Sól (2)";171;112;59;22;39;36;73;
0804063;"Nowe Miasteczko (3)";162;107;55;21;43;30;74;
0804064;"Nowe Miasteczko - miasto (4)";81;49;32;9;18;14;38;
0804065;"Nowe Miasteczko - obszar wiejski (5)";81;58;23;12;25;16;36;
0804073;"Otyń (3)";185;114;71;22;54;48;56;
0804074;"Otyń - miasto (4)";38;24;14;6;11;11;9;
0804075;"Otyń - obszar wiejski (5)";147;90;57;16;43;37;47;
0804082;"Siedlisko (2)";102;65;37;12;27;22;40;
0805000;"Powiat słubicki";636;339;297;74;140;182;152;
0805013;"Cybinka (3)";130;70;60;18;30;32;50;
0805014;"Cybinka - miasto (4)";38;21;17;6;9;8;11;
0805015;"Cybinka - obszar wiejski (5)";92;49;43;12;21;24;39;
0805022;"Górzyca (2)";60;35;25;13;15;16;19;
0805033;"Ośno Lubuskie (3)";79;34;45;6;16;26;22;
0805034;"Ośno Lubuskie - miasto (4)";44;18;26;3;10;15;9;
0805035;"Ośno Lubuskie - obszar wiejski (5)";35;16;19;3;6;11;13;
0805043;"Rzepin (3)";129;74;55;15;31;41;24;
0805044;"Rzepin - miasto (4)";91;53;38;11;21;27;15;
0805045;"Rzepin - obszar wiejski (5)";38;21;17;4;10;14;9;
0805053;"Słubice (3)";238;126;112;22;48;67;37;
0805054;"Słubice - miasto (4)";198;104;94;16;37;52;25;
0805055;"Słubice - obszar wiejski (5)";40;22;18;6;11;15;12;
0806000;"Powiat strzelecko-drezdenecki";1935;1142;793;293;560;504;815;
0806013;"Dobiegniew (3)";380;202;178;57;104;103;221;
0806014;"Dobiegniew - miasto (4)";161;85;76;24;49;40;86;
0806015;"Dobiegniew - obszar wiejski (5)";219;117;102;33;55;63;135;
0806023;"Drezdenko (3)";637;358;279;82;171;172;271;
0806024;"Drezdenko - miasto (4)";355;192;163;42;90;99;147;
0806025;"Drezdenko - obszar wiejski (5)";282;166;116;40;81;73;124;
0806032;"Stare Kurowo (2)";146;84;62;28;51;37;65;
0806043;"Strzelce Krajeńskie (3)";624;400;224;103;186;155;207;
0806044;"Strzelce Krajeńskie - miasto (4)";314;195;119;50;81;79;95;
0806045;"Strzelce Krajeńskie - obszar wiejski (5)";310;205;105;53;105;76;112;
0806052;"Zwierzyn (2)";148;98;50;23;48;37;51;
0807000;"Powiat sulęciński";857;441;416;110;236;236;298;
0807012;"Krzeszyce (2)";103;61;42;17;36;28;46;
0807023;"Lubniewice (3)";93;39;54;5;11;33;38;
0807024;"Lubniewice - miasto (4)";70;28;42;2;6;23;27;
0807025;"Lubniewice - obszar wiejski (5)";23;11;12;3;5;10;11;
0807032;"Słońsk (2)";68;48;20;9;24;7;22;
0807043;"Sulęcin (3)";387;193;194;55;117;102;127;
0807044;"Sulęcin - miasto (4)";254;120;134;42;79;66;85;
0807045;"Sulęcin - obszar wiejski (5)";133;73;60;13;38;36;42;
0807053;"Torzym (3)";206;100;106;24;48;66;65;
0807054;"Torzym - miasto (4)";68;29;39;6;15;25;18;
0807055;"Torzym - obszar wiejski (5)";138;71;67;18;33;41;47;
0808000;"Powiat świebodziński";1246;630;616;158;345;307;378;
0808012;"Lubrza (2)";94;46;48;12;26;27;36;
0808022;"Łagów (2)";128;69;59;14;37;38;51;
0808032;"Skąpe (2)";103;55;48;16;32;24;35;
0808042;"Szczaniec (2)";105;58;47;17;32;21;36;
0808053;"Świebodzin (3)";695;337;358;89;181;173;187;
0808054;"Świebodzin - miasto (4)";482;231;251;50;114;114;124;
0808055;"Świebodzin - obszar wiejski (5)";213;106;107;39;67;59;63;
0808063;"Zbąszynek (3)";121;65;56;10;37;24;33;
0808064;"Zbąszynek - miasto (4)";71;37;34;6;20;13;18;
0808065;"Zbąszynek - obszar wiejski (5)";50;28;22;4;17;11;15;
0809000;"Powiat zielonogórski";1920;1093;827;258;543;445;708;
0809013;"Babimost (3)";103;57;46;25;37;28;32;
0809014;"Babimost - miasto (4)";67;43;24;12;21;19;21;
0809015;"Babimost - obszar wiejski (5)";36;14;22;13;16;9;11;
0809022;"Bojadła (2)";95;44;51;14;27;30;51;
0809033;"Czerwieńsk (3)";236;134;102;29;53;61;78;
0809034;"Czerwieńsk - miasto (4)";76;35;41;15;22;17;16;
0809035;"Czerwieńsk - obszar wiejski (5)";160;99;61;14;31;44;62;
0809043;"Kargowa (3)";138;74;64;20;36;33;72;
0809044;"Kargowa - miasto (4)";81;43;38;15;23;20;39;
0809045;"Kargowa - obszar wiejski (5)";57;31;26;5;13;13;33;
0809053;"Nowogród Bobrzański (3)";247;153;94;30;84;51;85;
0809054;"Nowogród Bobrzański - miasto (4)";117;74;43;9;38;23;37;
0809055;"Nowogród Bobrzański - obszar wiejski (5)";130;79;51;21;46;28;48;
0809063;"Sulechów (3)";790;457;333;100;215;171;279;
0809064;"Sulechów - miasto (4)";449;253;196;54;126;93;137;
0809065;"Sulechów - obszar wiejski (5)";341;204;137;46;89;78;142;
0809072;"Świdnica (2)";104;69;35;11;22;21;30;
0809082;"Trzebiechów (2)";110;60;50;17;39;26;56;
0809092;"Zabór (2)";97;45;52;12;30;24;25;
0810000;"Powiat żagański";2093;1205;888;250;530;482;747;
0810011;"Gozdnica (1)";44;23;21;3;9;9;6;
0810021;"Żagań (1)";479;253;226;49;99;117;132;
0810032;"Brzeźnica (2)";99;64;35;10;30;25;49;
0810043;"Iłowa (3)";172;101;71;32;50;35;42;
0810044;"Iłowa - miasto (4)";83;44;39;16;25;11;21;
0810045;"Iłowa - obszar wiejski (5)";89;57;32;16;25;24;21;
0810053;"Małomice (3)";177;96;81;23;53;49;75;
0810054;"Małomice - miasto (4)";118;65;53;13;35;36;51;
0810055;"Małomice - obszar wiejski (5)";59;31;28;10;18;13;24;
0810062;"Niegosławice (2)";189;113;76;26;53;40;85;
0810073;"Szprotawa (3)";692;409;283;79;176;150;265;
0810074;"Szprotawa - miasto (4)";356;206;150;38;85;82;132;
0810075;"Szprotawa - obszar wiejski (5)";336;203;133;41;91;68;133;
0810082;"Wymiarki (2)";69;43;26;7;19;18;25;
0810092;"Żagań (2)";172;103;69;21;41;39;68;
0811000;"Powiat żarski";2112;1172;940;285;585;513;815;
0811011;"Łęknica (1)";39;19;20;5;14;8;12;
0811021;"Żary (1)";530;271;259;73;141;132;101;
0811032;"Brody (2)";128;76;52;9;36;30;72;
0811043;"Jasień (3)";234;139;95;30;61;49;117;
0811044;"Jasień - miasto (4)";120;68;52;22;42;21;56;
0811045;"Jasień - obszar wiejski (5)";114;71;43;8;19;28;61;
0811052;"Lipinki Łużyckie (2)";68;38;30;11;23;16;16;
0811063;"Lubsko (3)";636;358;278;85;155;164;327;
0811064;"Lubsko - miasto (4)";433;237;196;63;105;115;225;
0811065;"Lubsko - obszar wiejski (5)";203;121;82;22;50;49;102;
0811072;"Przewóz (2)";75;49;26;7;20;22;30;
0811082;"Trzebiel (2)";96;60;36;13;35;26;28;
0811092;"Tuplice (2)";104;50;54;15;32;26;52;
0811102;"Żary (2)";202;112;90;37;68;40;60;
0812000;"Powiat wschowski";1134;686;448;166;329;279;503;
0812013;"Sława (3)";293;178;115;59;101;73;106;
0812014;"Sława - miasto (4)";96;57;39;20;38;23;42;
0812015;"Sława - obszar wiejski (5)";197;121;76;39;63;50;64;
0812023;"Szlichtyngowa (3)";172;112;60;23;45;42;77;
0812024;"Szlichtyngowa - miasto (4)";49;27;22;5;12;14;24;
0812025;"Szlichtyngowa - obszar wiejski (5)";123;85;38;18;33;28;53;
0812033;"Wschowa (3)";669;396;273;84;183;164;320;
0812034;"Wschowa - miasto (4)";435;263;172;55;121;115;201;
0812035;"Wschowa - obszar wiejski (5)";234;133;101;29;62;49;119;
0861000;"Powiat m.Gorzów Wielkopolski";2103;1145;958;220;501;570;418;
0861011;"Gorzów Wielkopolski (1)";2103;1145;958;220;501;570;418;
0862000;"Powiat m.Zielona Góra";2439;1310;1129;219;546;607;728;
0862011;"Zielona Góra (1)";2439;1310;1129;219;546;607;728;
1000000;"ŁÓDZKIE";67236;34544;32692;7149;15552;19126;32248;
1001000;"Powiat bełchatowski";2948;1788;1160;321;762;648;1442;
1001011;"Bełchatów (1)";1380;865;515;113;320;295;628;
1001022;"Bełchatów (2)";239;149;90;35;70;55;114;
1001032;"Drużbice (2)";116;73;43;16;34;25;57;
1001042;"Kleszczów (2)";111;71;40;17;42;23;47;
1001052;"Kluki (2)";105;64;41;12;25;34;47;
1001062;"Rusiec (2)";88;59;29;22;40;9;38;
1001072;"Szczerców (2)";197;128;69;29;66;40;84;
1001083;"Zelów (3)";712;379;333;77;165;167;427;
1001084;"Zelów - miasto (4)";394;209;185;38;87;102;236;
1001085;"Zelów - obszar wiejski (5)";318;170;148;39;78;65;191;
1002000;"Powiat kutnowski";3382;1928;1454;415;893;825;1969;
1002011;"Kutno (1)";1185;678;507;116;269;284;637;
1002022;"Bedlno (2)";135;60;75;24;38;34;63;
1002032;"Dąbrowice (2)";79;44;35;18;34;7;41;
1002043;"Krośniewice (3)";383;216;167;53;105;103;254;
1002044;"Krośniewice - miasto (4)";216;118;98;28;58;62;139;
1002045;"Krośniewice - obszar wiejski (5)";167;98;69;25;47;41;115;
1002052;"Krzyżanów (2)";164;88;76;17;54;46;102;
1002062;"Kutno (2)";299;176;123;40;91;72;163;
1002072;"Łanięta (2)";109;61;48;20;34;25;67;
1002082;"Nowe Ostrowy (2)";180;97;83;24;46;51;103;
1002092;"Oporów (2)";87;45;42;12;23;19;57;
1002102;"Strzelce (2)";133;80;53;25;50;22;68;
1002113;"Żychlin (3)";628;383;245;66;149;162;414;
1002114;"Żychlin - miasto (4)";426;262;164;46;97;108;277;
1002115;"Żychlin - obszar wiejski (5)";202;121;81;20;52;54;137;
1003000;"Powiat łaski";1404;707;697;178;352;399;662;
1003012;"Buczek (2)";131;62;69;18;33;38;61;
1003023;"Łask (3)";801;393;408;94;187;225;353;
1003024;"Łask - miasto (4)";487;245;242;56;118;138;219;
1003025;"Łask - obszar wiejski (5)";314;148;166;38;69;87;134;
1003032;"Sędziejowice (2)";192;82;110;20;49;55;87;
1003042;"Widawa (2)";214;122;92;39;68;67;129;
1003052;"Wodzierady (2)";66;48;18;7;15;14;32;
1004000;"Powiat łęczycki";1446;721;725;161;355;427;815;
1004011;"Łęczyca (1)";639;324;315;68;140;201;391;
1004022;"Daszyna (2)";97;56;41;9;30;27;53;
1004032;"Góra Świętej Małgorzaty (2)";70;32;38;6;16;12;39;
1004042;"Grabów (2)";118;59;59;11;26;36;53;
1004052;"Łęczyca (2)";210;100;110;23;54;61;119;
1004063;"Piątek (3)";128;53;75;25;44;33;64;
1004064;"Piątek - miasto (4)";57;21;36;7;13;22;28;
1004065;"Piątek - obszar wiejski (5)";71;32;39;18;31;11;36;
1004072;"Świnice Warckie (2)";111;59;52;12;31;29;59;
1004082;"Witonia (2)";73;38;35;7;14;28;37;
1005000;"Powiat łowicki";1720;836;884;228;447;517;858;
1005011;"Łowicz (1)";792;377;415;81;154;258;409;
1005022;"Bielawy (2)";104;56;48;11;27;35;59;
1005032;"Chąśno (2)";55;32;23;11;24;12;29;
1005042;"Domaniewice (2)";83;38;45;10;20;31;39;
1005052;"Kiernozia (2)";61;27;34;15;22;15;24;
1005062;"Kocierzew Południowy (2)";52;34;18;14;28;8;24;
1005072;"Łowicz (2)";154;79;75;27;49;37;80;
1005082;"Łyszkowice (2)";133;64;69;14;34;44;63;
1005092;"Nieborów (2)";187;86;101;27;54;57;84;
1005102;"Zduny (2)";99;43;56;18;35;20;47;
1006000;"Powiat łódzki wschodni";2056;965;1091;158;414;612;995;
1006022;"Andrespol (2)";377;182;195;27;82;111;188;
1006032;"Brójce (2)";134;75;59;16;32;30;63;
1006073;"Koluszki (3)";811;384;427;67;159;231;386;
1006074;"Koluszki - miasto (4)";455;203;252;33;87;125;215;
1006075;"Koluszki - obszar wiejski (5)";356;181;175;34;72;106;171;
1006082;"Nowosolna (2)";116;50;66;12;28;34;49;
1006103;"Rzgów (3)";255;103;152;16;42;83;124;
1006104;"Rzgów - miasto (4)";95;34;61;5;10;37;50;
1006105;"Rzgów - obszar wiejski (5)";160;69;91;11;32;46;74;
1006113;"Tuszyn (3)";363;171;192;20;71;123;185;
1006114;"Tuszyn - miasto (4)";264;126;138;11;49;101;142;
1006115;"Tuszyn - obszar wiejski (5)";99;45;54;9;22;22;43;
1007000;"Powiat opoczyński";2032;1060;972;264;532;568;700;
1007012;"Białaczów (2)";227;118;109;35;63;70;93;
1007023;"Drzewica (3)";306;161;145;39;74;101;112;
1007024;"Drzewica - miasto (4)";102;50;52;7;17;36;36;
1007025;"Drzewica - obszar wiejski (5)";204;111;93;32;57;65;76;
1007032;"Mniszków (2)";89;50;39;16;32;23;32;
1007043;"Opoczno (3)";914;482;432;108;228;227;307;
1007044;"Opoczno - miasto (4)";572;297;275;62;132;145;185;
1007045;"Opoczno - obszar wiejski (5)";342;185;157;46;96;82;122;
1007052;"Paradyż (2)";93;47;46;16;26;23;30;
1007062;"Poświętne (2)";47;28;19;7;16;16;15;
1007072;"Sławno (2)";174;76;98;26;46;46;59;
1007082;"Żarnów (2)";182;98;84;17;47;62;52;
1008000;"Powiat pabianicki";3294;1610;1684;308;642;982;1530;
1008011;"Konstantynów Łódzki (1)";553;257;296;55;121;160;266;
1008021;"Pabianice (1)";1905;926;979;163;340;575;877;
1008032;"Dłutów (2)";82;40;42;10;18;25;33;
1008042;"Dobroń (2)";186;91;95;19;36;58;79;
1008052;"Ksawerów (2)";164;81;83;14;31;49;77;
1008062;"Lutomiersk (2)";261;140;121;28;65;69;139;
1008072;"Pabianice (2)";143;75;68;19;31;46;59;
1009000;"Powiat pajęczański";1601;884;717;262;497;371;758;
1009013;"Działoszyn (3)";282;153;129;53;98;62;97;
1009014;"Działoszyn - miasto (4)";132;72;60;23;45;28;37;
1009015;"Działoszyn - obszar wiejski (5)";150;81;69;30;53;34;60;
1009022;"Kiełczygłów (2)";115;65;50;23;39;30;38;
1009032;"Nowa Brzeźnica (2)";194;97;97;23;54;43;112;
1009043;"Pajęczno (3)";347;186;161;46;95;97;179;
1009044;"Pajęczno - miasto (4)";206;109;97;22;47;61;114;
1009045;"Pajęczno - obszar wiejski (5)";141;77;64;24;48;36;65;
1009052;"Rząśnia (2)";235;163;72;40;78;46;114;
1009062;"Siemkowice (2)";124;63;61;27;45;19;59;
1009072;"Strzelce Wielkie (2)";139;58;81;24;42;27;74;
1009082;"Sulmierzyce (2)";165;99;66;26;46;47;85;
1010000;"Powiat piotrkowski";1839;957;882;249;533;491;782;
1010012;"Aleksandrów (2)";76;39;37;9;21;19;36;
1010022;"Czarnocin (2)";42;20;22;5;13;9;13;
1010032;"Gorzkowice (2)";174;105;69;22;54;42;72;
1010042;"Grabica (2)";90;51;39;19;30;21;38;
1010052;"Łęki Szlacheckie (2)";70;39;31;13;31;14;31;
1010062;"Moszczenica (2)";242;116;126;37;72;67;96;
1010072;"Ręczno (2)";85;47;38;10;24;17;42;
1010082;"Rozprza (2)";263;144;119;40;77;60;86;
1010093;"Sulejów (3)";422;198;224;57;111;122;187;
1010094;"Sulejów - miasto (4)";171;79;92;20;46;49;78;
1010095;"Sulejów - obszar wiejski (5)";251;119;132;37;65;73;109;
1010102;"Wola Krzysztoporska (2)";253;137;116;23;64;82;132;
1010113;"Wolbórz (3)";122;61;61;14;36;38;49;
1010114;"Wolbórz - miasto (4)";33;14;19;5;10;10;10;
1010115;"Wolbórz - obszar wiejski (5)";89;47;42;9;26;28;39;
1011000;"Powiat poddębicki";1216;574;642;169;355;318;657;
1011012;"Dalików (2)";97;47;50;18;31;22;52;
1011022;"Pęczniew (2)";128;61;67;24;47;29;74;
1011033;"Poddębice (3)";477;228;249;58;132;148;257;
1011034;"Poddębice - miasto (4)";220;111;109;21;54;74;118;
1011035;"Poddębice - obszar wiejski (5)";257;117;140;37;78;74;139;
1011043;"Uniejów (3)";205;99;106;26;55;41;107;
1011044;"Uniejów - miasto (4)";86;38;48;11;22;21;38;
1011045;"Uniejów - obszar wiejski (5)";119;61;58;15;33;20;69;
1011052;"Wartkowice (2)";167;78;89;25;48;39;85;
1011062;"Zadzim (2)";142;61;81;18;42;39;82;
1012000;"Powiat radomszczański";2873;1629;1244;390;835;768;1175;
1012011;"Radomsko (1)";1234;688;546;134;308;357;446;
1012022;"Dobryszyce (2)";97;56;41;11;30;26;32;
1012032;"Gidle (2)";148;70;78;23;32;61;57;
1012042;"Gomunice (2)";154;100;54;13;46;41;56;
1012053;"Kamieńsk (3)";103;66;37;16;32;24;37;
1012054;"Kamieńsk - miasto (4)";40;29;11;7;14;7;15;
1012055;"Kamieńsk - obszar wiejski (5)";63;37;26;9;18;17;22;
1012062;"Kobiele Wielkie (2)";101;57;44;16;32;21;50;
1012072;"Kodrąb (2)";88;62;26;20;41;13;34;
1012082;"Lgota Wielka (2)";57;35;22;9;20;14;23;
1012092;"Ładzice (2)";102;52;50;26;45;23;35;
1012102;"Masłowice (2)";160;93;67;14;40;29;88;
1012113;"Przedbórz (3)";313;173;140;44;94;83;187;
1012114;"Przedbórz - miasto (4)";168;92;76;12;37;46;100;
1012115;"Przedbórz - obszar wiejski (5)";145;81;64;32;57;37;87;
1012122;"Radomsko (2)";123;68;55;21;38;28;49;
1012132;"Wielgomłyny (2)";85;48;37;18;35;18;36;
1012142;"Żytno (2)";108;61;47;25;42;30;45;
1013000;"Powiat rawski";778;399;379;119;230;201;310;
1013011;"Rawa Mazowiecka (1)";347;170;177;36;80;83;130;
1013023;"Biała Rawska (3)";166;85;81;35;61;52;72;
1013024;"Biała Rawska - miasto (4)";68;35;33;10;20;24;29;
1013025;"Biała Rawska - obszar wiejski (5)";98;50;48;25;41;28;43;
1013032;"Cielądz (2)";60;35;25;11;19;15;26;
1013042;"Rawa Mazowiecka (2)";141;79;62;21;43;39;50;
1013052;"Regnów (2)";18;8;10;5;10;3;7;
1013062;"Sadkowice (2)";46;22;24;11;17;9;25;
1014000;"Powiat sieradzki";3134;1570;1564;534;1003;758;1399;
1014011;"Sieradz (1)";1240;611;629;148;307;337;517;
1014023;"Błaszki (3)";320;163;157;75;130;61;146;
1014024;"Błaszki - miasto (4)";85;54;31;20;35;15;36;
1014025;"Błaszki - obszar wiejski (5)";235;109;126;55;95;46;110;
1014032;"Brąszewice (2)";87;50;37;25;41;19;32;
1014042;"Brzeźnio (2)";139;74;65;29;55;34;71;
1014052;"Burzenin (2)";168;81;87;30;53;44;104;
1014062;"Goszczanów (2)";137;74;63;30;51;33;81;
1014072;"Klonowa (2)";46;27;19;9;20;9;15;
1014082;"Sieradz (2)";313;148;165;50;93;71;120;
1014093;"Warta (3)";363;175;188;71;126;94;170;
1014094;"Warta - miasto (4)";133;54;79;15;34;36;58;
1014095;"Warta - obszar wiejski (5)";230;121;109;56;92;58;112;
1014102;"Wróblew (2)";127;60;67;28;49;27;60;
1014113;"Złoczew (3)";194;107;87;39;78;29;83;
1014114;"Złoczew - miasto (4)";103;57;46;17;35;14;42;
1014115;"Złoczew - obszar wiejski (5)";91;50;41;22;43;15;41;
1015000;"Powiat skierniewicki";698;401;297;107;225;160;310;
1015012;"Bolimów (2)";69;52;17;10;21;15;28;
1015022;"Głuchów (2)";60;34;26;7;17;20;29;
1015032;"Godzianów (2)";35;20;15;12;20;2;12;
1015042;"Kowiesy (2)";55;29;26;9;18;10;30;
1015052;"Lipce Reymontowskie (2)";54;29;25;12;18;9;21;
1015062;"Maków (2)";126;67;59;22;43;28;57;
1015072;"Nowy Kawęczyn (2)";51;32;19;10;21;10;22;
1015082;"Skierniewice (2)";212;119;93;18;51;59;95;
1015092;"Słupia (2)";36;19;17;7;16;7;16;
1016000;"Powiat tomaszowski";3760;1922;1838;404;895;991;1669;
1016011;"Tomaszów Mazowiecki (1)";2271;1170;1101;214;493;592;1015;
1016022;"Będków (2)";65;31;34;6;14;21;31;
1016032;"Budziszewice (2)";56;31;25;8;17;11;32;
1016042;"Czerniewice (2)";120;63;57;14;30;40;59;
1016052;"Inowłódz (2)";136;64;72;17;34;43;57;
1016062;"Lubochnia (2)";246;132;114;31;74;61;108;
1016072;"Rokiciny (2)";115;51;64;19;34;31;59;
1016082;"Rzeczyca (2)";119;58;61;21;47;22;48;
1016092;"Tomaszów Mazowiecki (2)";314;159;155;38;79;81;123;
1016102;"Ujazd (2)";235;127;108;28;53;64;99;
1016112;"Żelechlinek (2)";83;36;47;8;20;25;38;
1017000;"Powiat wieluński";2120;1187;933;324;654;473;1068;
1017012;"Biała (2)";124;72;52;30;53;23;57;
1017022;"Czarnożyły (2)";104;66;38;18;41;16;45;
1017032;"Konopnica (2)";103;59;44;18;32;20;60;
1017042;"Mokrsko (2)";109;66;43;21;37;21;40;
1017052;"Osjaków (2)";143;80;63;24;46;36;67;
1017062;"Ostrówek (2)";126;61;65;22;46;32;63;
1017072;"Pątnów (2)";149;87;62;32;61;26;69;
1017082;"Skomlin (2)";90;55;35;11;28;18;49;
1017093;"Wieluń (3)";976;532;444;111;250;238;521;
1017094;"Wieluń - miasto (4)";711;387;324;70;173;179;378;
1017095;"Wieluń - obszar wiejski (5)";265;145;120;41;77;59;143;
1017102;"Wierzchlas (2)";196;109;87;37;60;43;97;
1018000;"Powiat wieruszowski";973;481;492;177;335;224;363;
1018012;"Bolesławiec (2)";94;50;44;22;39;17;39;
1018022;"Czastary (2)";85;37;48;16;27;24;32;
1018032;"Galewice (2)";156;66;90;27;53;47;55;
1018043;"Lututów (3)";82;31;51;15;34;17;36;
1018044;"Lututów - miasto (4)";38;15;23;6;13;10;15;
1018045;"Lututów - obszar wiejski (5)";44;16;28;9;21;7;21;
1018052;"Łubnice (2)";73;30;43;12;31;16;19;
1018062;"Sokolniki (2)";108;54;54;21;37;26;45;
1018073;"Wieruszów (3)";375;213;162;64;114;77;137;
1018074;"Wieruszów - miasto (4)";228;129;99;34;65;47;81;
1018075;"Wieruszów - obszar wiejski (5)";147;84;63;30;49;30;56;
1019000;"Powiat zduńskowolski";1889;1073;816;219;439;520;890;
1019011;"Zduńska Wola (1)";1317;763;554;147;292;359;635;
1019023;"Szadek (3)";145;84;61;18;39;35;69;
1019024;"Szadek - miasto (4)";43;26;17;6;14;9;20;
1019025;"Szadek - obszar wiejski (5)";102;58;44;12;25;26;49;
1019032;"Zapolice (2)";117;59;58;15;25;36;55;
1019042;"Zduńska Wola (2)";310;167;143;39;83;90;131;
1020000;"Powiat zgierski";4313;2216;2097;455;971;1233;1676;
1020011;"Głowno (1)";413;210;203;44;91;115;163;
1020021;"Ozorków (1)";768;399;369;63;139;241;361;
1020031;"Zgierz (1)";1381;709;672;140;298;393;488;
1020043;"Aleksandrów Łódzki (3)";812;436;376;87;178;230;288;
1020044;"Aleksandrów Łódzki - miasto (4)";621;320;301;63;131;180;216;
1020045;"Aleksandrów Łódzki - obszar wiejski (5)";191;116;75;24;47;50;72;
1020052;"Głowno (2)";77;35;42;18;35;18;20;
1020062;"Ozorków (2)";201;102;99;23;55;62;115;
1020072;"Parzęczew (2)";158;71;87;16;41;40;78;
1020083;"Stryków (3)";238;122;116;35;70;53;67;
1020084;"Stryków - miasto (4)";89;38;51;17;26;24;31;
1020085;"Stryków - obszar wiejski (5)";149;84;65;18;44;29;36;
1020092;"Zgierz (2)";265;132;133;29;64;81;96;
1021000;"Powiat brzeziński";901;429;472;115;222;240;444;
1021011;"Brzeziny (1)";438;212;226;49;104;116;205;
1021022;"Brzeziny (2)";146;72;74;25;42;31;68;
1021032;"Dmosin (2)";124;64;60;17;32;37;76;
1021042;"Jeżów (2)";77;31;46;15;21;26;37;
1021052;"Rogów (2)";116;50;66;9;23;30;58;
1061000;"Powiat m.Łódź";19760;9511;10249;1281;3259;6556;10328;
1061011;"Łódź (1)";19760;9511;10249;1281;3259;6556;10328;
1062000;"Powiat m.Piotrków Trybunalski";2010;1080;930;211;460;535;930;
1062011;"Piotrków Trybunalski (1)";2010;1080;930;211;460;535;930;
1063000;"Powiat m.Skierniewice";1089;616;473;100;242;309;518;
1063011;"Skierniewice (1)";1089;616;473;100;242;309;518;
1200000;"MAŁOPOLSKIE";79677;43538;36139;11742;23867;18998;32630;
1201000;"Powiat bocheński";1559;867;692;266;510;371;584;
1201011;"Bochnia (1)";481;268;213;57;125;129;211;
1201022;"Bochnia (2)";319;183;136;51;106;73;120;
1201032;"Drwinia (2)";67;33;34;11;21;16;27;
1201042;"Lipnica Murowana (2)";76;43;33;14;30;17;30;
1201052;"Łapanów (2)";120;62;58;31;47;24;41;
1201063;"Nowy Wiśnicz (3)";191;105;86;43;77;43;60;
1201064;"Nowy Wiśnicz - miasto (4)";40;22;18;7;14;11;15;
1201065;"Nowy Wiśnicz - obszar wiejski (5)";151;83;68;36;63;32;45;
1201072;"Rzezawa (2)";178;100;78;30;52;47;65;
1201082;"Trzciana (2)";54;26;28;12;20;9;14;
1201092;"Żegocina (2)";73;47;26;17;32;13;16;
1202000;"Powiat brzeski";2019;1222;797;331;665;483;885;
1202012;"Borzęcin (2)";208;120;88;33;65;59;106;
1202023;"Brzesko (3)";950;577;373;130;270;225;441;
1202024;"Brzesko - miasto (4)";443;267;176;45;117;101;216;
1202025;"Brzesko - obszar wiejski (5)";507;310;197;85;153;124;225;
1202033;"Czchów (3)";167;100;67;34;63;40;68;
1202034;"Czchów - miasto (4)";42;24;18;8;16;14;19;
1202035;"Czchów - obszar wiejski (5)";125;76;49;26;47;26;49;
1202042;"Dębno (2)";313;187;126;60;120;66;122;
1202052;"Gnojnik (2)";133;88;45;22;52;34;48;
1202062;"Iwkowa (2)";85;46;39;24;41;13;22;
1202072;"Szczurowa (2)";163;104;59;28;54;46;78;
1203000;"Powiat chrzanowski";3225;1739;1486;384;843;836;1389;
1203013;"Alwernia (3)";275;133;142;43;85;61;101;
1203014;"Alwernia - miasto (4)";84;40;44;13;27;16;28;
1203015;"Alwernia - obszar wiejski (5)";191;93;98;30;58;45;73;
1203022;"Babice (2)";205;116;89;31;70;47;67;
1203033;"Chrzanów (3)";1357;727;630;142;309;382;619;
1203034;"Chrzanów - miasto (4)";1097;588;509;114;248;305;502;
1203035;"Chrzanów - obszar wiejski (5)";260;139;121;28;61;77;117;
1203043;"Libiąż (3)";478;268;210;64;133;123;196;
1203044;"Libiąż - miasto (4)";369;204;165;51;102;93;152;
1203045;"Libiąż - obszar wiejski (5)";109;64;45;13;31;30;44;
1203053;"Trzebinia (3)";910;495;415;104;246;223;406;
1203054;"Trzebinia - miasto (4)";572;310;262;62;148;135;257;
1203055;"Trzebinia - obszar wiejski (5)";338;185;153;42;98;88;149;
1204000;"Powiat dąbrowski";2613;1485;1128;526;1013;486;1425;
1204012;"Bolesław (2)";85;42;43;26;39;12;35;
1204023;"Dąbrowa Tarnowska (3)";920;512;408;169;318;179;484;
1204024;"Dąbrowa Tarnowska - miasto (4)";479;254;225;69;139;102;249;
1204025;"Dąbrowa Tarnowska - obszar wiejski (5)";441;258;183;100;179;77;235;
1204032;"Gręboszów (2)";86;61;25;16;35;19;64;
1204042;"Mędrzechów (2)";164;96;68;29;69;28;94;
1204052;"Olesno (2)";343;188;155;73;148;56;180;
1204062;"Radgoszcz (2)";316;178;138;81;144;55;159;
1204073;"Szczucin (3)";699;408;291;132;260;137;409;
1204074;"Szczucin - miasto (4)";200;126;74;43;75;36;105;
1204075;"Szczucin - obszar wiejski (5)";499;282;217;89;185;101;304;
1205000;"Powiat gorlicki";2838;1674;1164;475;883;652;1102;
1205011;"Gorlice (1)";797;465;332;92;178;187;310;
1205023;"Biecz (3)";453;250;203;81;151;117;185;
1205024;"Biecz - miasto (4)";146;83;63;15;40;33;59;
1205025;"Biecz - obszar wiejski (5)";307;167;140;66;111;84;126;
1205033;"Bobowa (3)";176;114;62;48;71;30;67;
1205034;"Bobowa - miasto (4)";62;39;23;13;18;11;21;
1205035;"Bobowa - obszar wiejski (5)";114;75;39;35;53;19;46;
1205042;"Gorlice (2)";459;263;196;73;152;114;172;
1205052;"Lipinki (2)";218;122;96;46;74;41;74;
1205062;"Łużna (2)";208;123;85;40;67;52;85;
1205072;"Moszczenica (2)";117;75;42;22;45;22;49;
1205082;"Ropa (2)";119;67;52;27;42;27;44;
1205092;"Sękowa (2)";148;92;56;18;46;35;63;
1205102;"Uście Gorlickie (2)";143;103;40;28;57;27;53;
1206000;"Powiat krakowski";5243;2736;2507;799;1590;1310;2064;
1206012;"Czernichów (2)";269;128;141;55;89;72;106;
1206022;"Igołomia-Wawrzeńczyce (2)";80;47;33;15;33;17;37;
1206032;"Iwanowice (2)";157;75;82;43;71;27;62;
1206042;"Jerzmanowice-Przeginia (2)";202;88;114;41;74;44;61;
1206052;"Kocmyrzów-Luborzyca (2)";271;142;129;42;85;57;115;
1206063;"Krzeszowice (3)";746;410;336;101;210;185;307;
1206064;"Krzeszowice - miasto (4)";243;133;110;22;57;60;108;
1206065;"Krzeszowice - obszar wiejski (5)";503;277;226;79;153;125;199;
1206072;"Liszki (2)";325;179;146;58;105;81;124;
1206082;"Michałowice (2)";145;76;69;22;60;26;55;
1206092;"Mogilany (2)";281;155;126;35;83;77;124;
1206103;"Skała (3)";190;82;108;39;72;39;64;
1206104;"Skała - miasto (4)";59;28;31;15;23;9;19;
1206105;"Skała - obszar wiejski (5)";131;54;77;24;49;30;45;
1206113;"Skawina (3)";1043;549;494;151;275;288;398;
1206114;"Skawina - miasto (4)";617;321;296;73;137;174;257;
1206115;"Skawina - obszar wiejski (5)";426;228;198;78;138;114;141;
1206123;"Słomniki (3)";332;166;166;56;103;83;143;
1206124;"Słomniki - miasto (4)";148;74;74;17;31;41;65;
1206125;"Słomniki - obszar wiejski (5)";184;92;92;39;72;42;78;
1206132;"Sułoszowa (2)";90;48;42;22;44;16;34;
1206143;"Świątniki Górne (3)";218;121;97;32;60;55;85;
1206144;"Świątniki Górne - miasto (4)";52;29;23;7;15;18;19;
1206145;"Świątniki Górne - obszar wiejski (5)";166;92;74;25;45;37;66;
1206152;"Wielka Wieś (2)";180;92;88;23;55;40;60;
1206162;"Zabierzów (2)";421;221;200;32;98;135;188;
1206172;"Zielonki (2)";293;157;136;32;73;68;101;
1207000;"Powiat limanowski";4354;2558;1796;937;1694;825;1786;
1207011;"Limanowa (1)";437;247;190;76;143;83;179;
1207021;"Mszana Dolna (1)";327;153;174;63;118;65;149;
1207032;"Dobra (2)";334;200;134;78;152;47;156;
1207042;"Jodłownik (2)";258;152;106;63;117;40;111;
1207052;"Kamienica (2)";326;188;138;49;96;79;128;
1207062;"Laskowa (2)";204;122;82;52;86;35;69;
1207072;"Limanowa (2)";771;460;311;154;290;162;271;
1207082;"Łukowica (2)";373;247;126;73;136;78;177;
1207092;"Mszana Dolna (2)";640;380;260;155;268;113;293;
1207102;"Niedźwiedź (2)";243;151;92;58;106;49;96;
1207112;"Słopnice (2)";212;135;77;68;101;33;69;
1207122;"Tymbark (2)";229;123;106;48;81;41;88;
1208000;"Powiat miechowski";1045;548;497;181;330;214;480;
1208012;"Charsznica (2)";184;104;80;34;50;41;93;
1208022;"Gołcza (2)";128;72;56;19;38;32;66;
1208032;"Kozłów (2)";111;64;47;23;42;22;60;
1208042;"Książ Wielki (2)";87;45;42;15;24;15;42;
1208053;"Miechów (3)";437;210;227;64;129;94;177;
1208054;"Miechów - miasto (4)";295;131;164;34;75;74;117;
1208055;"Miechów - obszar wiejski (5)";142;79;63;30;54;20;60;
1208062;"Racławice (2)";27;16;11;10;18;1;9;
1208072;"Słaboszów (2)";71;37;34;16;29;9;33;
1209000;"Powiat myślenicki";1940;991;949;381;681;442;355;
1209013;"Dobczyce (3)";276;138;138;38;85;74;48;
1209014;"Dobczyce - miasto (4)";111;53;58;9;28;29;23;
1209015;"Dobczyce - obszar wiejski (5)";165;85;80;29;57;45;25;
1209022;"Lubień (2)";152;79;73;34;60;32;30;
1209033;"Myślenice (3)";685;345;340;107;203;167;131;
1209034;"Myślenice - miasto (4)";283;152;131;33;62;82;70;
1209035;"Myślenice - obszar wiejski (5)";402;193;209;74;141;85;61;
1209042;"Pcim (2)";163;88;75;47;73;34;25;
1209052;"Raciechowice (2)";80;36;44;22;35;15;20;
1209062;"Siepraw (2)";121;60;61;34;45;20;25;
1209073;"Sułkowice (3)";275;133;142;47;98;69;54;
1209074;"Sułkowice - miasto (4)";135;63;72;24;44;33;18;
1209075;"Sułkowice - obszar wiejski (5)";140;70;70;23;54;36;36;
1209082;"Tokarnia (2)";109;69;40;32;50;14;15;
1209092;"Wiśniowa (2)";79;43;36;20;32;17;7;
1210000;"Powiat nowosądecki";7086;4706;2380;1185;2412;1451;3316;
1210011;"Grybów (1)";187;130;57;29;68;30;98;
1210022;"Chełmiec (2)";1014;678;336;162;334;232;495;
1210032;"Gródek nad Dunajcem (2)";248;161;87;44;95;42;128;
1210042;"Grybów (2)";803;554;249;146;286;153;426;
1210052;"Kamionka Wielka (2)";398;280;118;81;149;80;186;
1210062;"Korzenna (2)";397;276;121;93;172;66;173;
1210073;"Krynica-Zdrój (3)";565;324;241;64;156;137;239;
1210074;"Krynica-Zdrój - miasto (4)";361;194;167;32;89;102;157;
1210075;"Krynica-Zdrój - obszar wiejski (5)";204;130;74;32;67;35;82;
1210082;"Łabowa (2)";209;139;70;40;68;40;76;
1210092;"Łącko (2)";538;374;164;79;165;115;255;
1210102;"Łososina Dolna (2)";260;174;86;45;97;48;141;
1210113;"Muszyna (3)";350;222;128;51;119;57;142;
1210114;"Muszyna - miasto (4)";147;86;61;23;53;27;68;
1210115;"Muszyna - obszar wiejski (5)";203;136;67;28;66;30;74;
1210122;"Nawojowa (2)";344;213;131;60;114;73;146;
1210133;"Piwniczna-Zdrój (3)";383;253;130;49;107;92;190;
1210134;"Piwniczna-Zdrój - miasto (4)";223;147;76;23;56;60;116;
1210135;"Piwniczna-Zdrój - obszar wiejski (5)";160;106;54;26;51;32;74;
1210142;"Podegrodzie (2)";429;283;146;89;169;61;200;
1210152;"Rytro (2)";123;87;36;22;46;25;53;
1210163;"Stary Sącz (3)";838;558;280;131;267;200;368;
1210164;"Stary Sącz - miasto (4)";300;194;106;49;94;78;137;
1210165;"Stary Sącz - obszar wiejski (5)";538;364;174;82;173;122;231;
1211000;"Powiat nowotarski";4610;2255;2355;937;1733;972;1698;
1211011;"Nowy Targ (1)";967;469;498;124;260;238;371;
1211023;"Szczawnica (3)";324;163;161;36;95;87;131;
1211024;"Szczawnica - miasto (4)";259;135;124;27;73;72;106;
1211025;"Szczawnica - obszar wiejski (5)";65;28;37;9;22;15;25;
1211032;"Czarny Dunajec (2)";464;231;233;119;220;72;211;
1211042;"Czorsztyn (2)";170;80;90;49;78;30;46;
1211052;"Jabłonka (2)";388;182;206;118;187;62;126;
1211062;"Krościenko nad Dunajcem (2)";178;77;101;39;74;40;60;
1211072;"Lipnica Wielka (2)";104;48;56;30;45;20;28;
1211082;"Łapsze Niżne (2)";153;77;76;30;66;26;46;
1211092;"Nowy Targ (2)";483;247;236;113;211;75;146;
1211102;"Ochotnica Dolna (2)";213;112;101;50;89;41;62;
1211112;"Raba Wyżna (2)";298;141;157;63;109;64;95;
1211123;"Rabka-Zdrój (3)";476;226;250;70;133;133;222;
1211124;"Rabka-Zdrój - miasto (4)";367;167;200;57;106;110;165;
1211125;"Rabka-Zdrój - obszar wiejski (5)";109;59;50;13;27;23;57;
1211132;"Spytkowice (2)";142;69;73;40;65;27;63;
1211142;"Szaflary (2)";250;133;117;56;101;57;91;
1212000;"Powiat olkuski";3783;1992;1791;443;951;864;1960;
1212011;"Bukowno (1)";309;182;127;32;83;64;166;
1212032;"Bolesław (2)";254;143;111;33;69;49;133;
1212042;"Klucze (2)";569;295;274;63;138;136;289;
1212053;"Olkusz (3)";1809;959;850;178;396;428;963;
1212054;"Olkusz - miasto (4)";1330;697;633;122;267;312;716;
1212055;"Olkusz - obszar wiejski (5)";479;262;217;56;129;116;247;
1212062;"Trzyciąż (2)";160;74;86;33;56;30;75;
1212073;"Wolbrom (3)";682;339;343;104;209;157;334;
1212074;"Wolbrom - miasto (4)";278;132;146;33;79;80;136;
1212075;"Wolbrom - obszar wiejski (5)";404;207;197;71;130;77;198;
1213000;"Powiat oświęcimski";3570;2018;1552;529;1039;866;1359;
1213011;"Oświęcim (1)";1058;609;449;133;275;272;439;
1213023;"Brzeszcze (3)";356;213;143;60;109;73;116;
1213024;"Brzeszcze - miasto (4)";210;131;79;33;62;48;72;
1213025;"Brzeszcze - obszar wiejski (5)";146;82;64;27;47;25;44;
1213033;"Chełmek (3)";240;134;106;40;71;59;57;
1213034;"Chełmek - miasto (4)";168;86;82;25;48;44;42;
1213035;"Chełmek - obszar wiejski (5)";72;48;24;15;23;15;15;
1213043;"Kęty (3)";1086;591;495;152;298;260;491;
1213044;"Kęty - miasto (4)";596;316;280;73;160;147;283;
1213045;"Kęty - obszar wiejski (5)";490;275;215;79;138;113;208;
1213052;"Osiek (2)";153;89;64;29;51;36;55;
1213062;"Oświęcim (2)";286;171;115;50;105;86;71;
1213072;"Polanka Wielka (2)";74;42;32;16;33;10;23;
1213082;"Przeciszów (2)";116;61;55;23;38;22;40;
1213093;"Zator (3)";201;108;93;26;59;48;67;
1213094;"Zator - miasto (4)";81;40;41;12;24;19;28;
1213095;"Zator - obszar wiejski (5)";120;68;52;14;35;29;39;
1214000;"Powiat proszowicki";976;461;515;230;385;174;428;
1214012;"Koniusza (2)";146;62;84;35;58;20;67;
1214023;"Koszyce (3)";126;71;55;37;54;24;52;
1214024;"Koszyce - miasto (4)";21;14;7;7;9;2;10;
1214025;"Koszyce - obszar wiejski (5)";105;57;48;30;45;22;42;
1214033;"Nowe Brzesko (3)";139;63;76;29;52;32;60;
1214034;"Nowe Brzesko - miasto (4)";51;23;28;7;16;13;28;
1214035;"Nowe Brzesko - obszar wiejski (5)";88;40;48;22;36;19;32;
1214042;"Pałecznica (2)";61;27;34;20;31;5;26;
1214053;"Proszowice (3)";433;199;234;94;163;79;193;
1214054;"Proszowice - miasto (4)";185;82;103;26;53;40;80;
1214055;"Proszowice - obszar wiejski (5)";248;117;131;68;110;39;113;
1214062;"Radziemice (2)";71;39;32;15;27;14;30;
1215000;"Powiat suski";1989;1046;943;425;765;430;623;
1215011;"Jordanów (1)";109;57;52;22;40;21;29;
1215021;"Sucha Beskidzka (1)";269;134;135;49;92;66;108;
1215032;"Budzów (2)";211;125;86;49;87;42;75;
1215042;"Bystra-Sidzina (2)";111;54;57;29;53;28;25;
1215052;"Jordanów (2)";203;125;78;60;96;34;64;
1215063;"Maków Podhalański (3)";404;211;193;75;146;89;133;
1215064;"Maków Podhalański - miasto (4)";168;83;85;24;49;49;54;
1215065;"Maków Podhalański - obszar wiejski (5)";236;128;108;51;97;40;79;
1215072;"Stryszawa (2)";285;148;137;56;111;68;74;
1215082;"Zawoja (2)";264;128;136;62;98;52;71;
1215092;"Zembrzyce (2)";133;64;69;23;42;30;44;
1216000;"Powiat tarnowski";4876;2924;1952;796;1624;1078;2234;
1216013;"Ciężkowice (3)";231;147;84;38;80;36;92;
1216014;"Ciężkowice - miasto (4)";64;41;23;7;14;11;22;
1216015;"Ciężkowice - obszar wiejski (5)";167;106;61;31;66;25;70;
1216022;"Gromnik (2)";198;118;80;27;68;53;101;
1216032;"Lisia Góra (2)";398;244;154;60;123;98;160;
1216042;"Pleśna (2)";305;179;126;54;100;52;141;
1216053;"Radłów (3)";263;155;108;50;97;51;137;
1216054;"Radłów - miasto (4)";92;54;38;16;34;15;54;
1216055;"Radłów - obszar wiejski (5)";171;101;70;34;63;36;83;
1216063;"Ryglice (3)";237;138;99;51;97;50;86;
1216064;"Ryglice - miasto (4)";61;30;31;10;17;18;29;
1216065;"Ryglice - obszar wiejski (5)";176;108;68;41;80;32;57;
1216072;"Rzepiennik Strzyżewski (2)";137;71;66;26;58;25;56;
1216082;"Skrzyszów (2)";341;214;127;58;119;76;133;
1216092;"Tarnów (2)";620;384;236;76;168;145;270;
1216103;"Tuchów (3)";444;255;189;86;163;87;193;
1216104;"Tuchów - miasto (4)";150;80;70;28;52;29;66;
1216105;"Tuchów - obszar wiejski (5)";294;175;119;58;111;58;127;
1216112;"Wierzchosławice (2)";254;155;99;36;66;62;107;
1216122;"Wietrzychowice (2)";126;73;53;27;53;29;78;
1216133;"Wojnicz (3)";268;150;118;50;94;77;108;
1216134;"Wojnicz - miasto (4)";63;40;23;9;19;15;28;
1216135;"Wojnicz - obszar wiejski (5)";205;110;95;41;75;62;80;
1216143;"Zakliczyn (3)";226;147;79;47;94;44;111;
1216144;"Zakliczyn - miasto (4)";30;20;10;1;9;3;15;
1216145;"Zakliczyn - obszar wiejski (5)";196;127;69;46;85;41;96;
1216153;"Żabno (3)";642;380;262;78;171;169;349;
1216154;"Żabno - miasto (4)";130;75;55;17;37;23;58;
1216155;"Żabno - obszar wiejski (5)";512;305;207;61;134;146;291;
1216162;"Szerzyny (2)";186;114;72;32;73;24;112;
1217000;"Powiat tatrzański";2599;1125;1474;356;773;661;1441;
1217011;"Zakopane (1)";1146;489;657;122;282;346;662;
1217022;"Biały Dunajec (2)";251;113;138;36;78;52;145;
1217032;"Bukowina Tatrzańska (2)";362;176;186;57;127;82;177;
1217042;"Kościelisko (2)";360;145;215;57;113;85;192;
1217052;"Poronin (2)";480;202;278;84;173;96;265;
1218000;"Powiat wadowicki";4361;2333;2028;656;1285;1032;1491;
1218013;"Andrychów (3)";1522;811;711;201;399;407;610;
1218014;"Andrychów - miasto (4)";778;403;375;94;188;216;324;
1218015;"Andrychów - obszar wiejski (5)";744;408;336;107;211;191;286;
1218022;"Brzeźnica (2)";192;108;84;26;61;43;55;
1218033;"Kalwaria Zebrzydowska (3)";506;242;264;95;166;105;132;
1218034;"Kalwaria Zebrzydowska - miasto (4)";110;57;53;18;33;21;29;
1218035;"Kalwaria Zebrzydowska - obszar wiejski (5)";396;185;211;77;133;84;103;
1218042;"Lanckorona (2)";176;99;77;37;68;37;55;
1218052;"Mucharz (2)";101;57;44;17;31;24;34;
1218062;"Spytkowice (2)";217;129;88;38;72;45;66;
1218072;"Stryszów (2)";198;118;80;38;60;41;56;
1218082;"Tomice (2)";158;97;61;28;59;32;55;
1218093;"Wadowice (3)";991;490;501;135;280;241;322;
1218094;"Wadowice - miasto (4)";523;271;252;58;134;127;210;
1218095;"Wadowice - obszar wiejski (5)";468;219;249;77;146;114;112;
1218102;"Wieprz (2)";300;182;118;41;89;57;106;
1219000;"Powiat wielicki";2691;1457;1234;345;704;719;1060;
1219012;"Biskupice (2)";206;119;87;32;64;52;78;
1219022;"Gdów (2)";383;224;159;65;124;84;159;
1219032;"Kłaj (2)";208;122;86;43;69;46;68;
1219043;"Niepołomice (3)";480;271;209;57;116;126;173;
1219044;"Niepołomice - miasto (4)";203;127;76;16;42;44;73;
1219045;"Niepołomice - obszar wiejski (5)";277;144;133;41;74;82;100;
1219053;"Wieliczka (3)";1414;721;693;148;331;411;582;
1219054;"Wieliczka - miasto (4)";591;297;294;54;127;167;232;
1219055;"Wieliczka - obszar wiejski (5)";823;424;399;94;204;244;350;
1261000;"Powiat m.Kraków";13394;6695;6699;1006;2798;3858;5096;
1261011;"Kraków (1)";13394;6695;6699;1006;2798;3858;5096;
1262000;"Powiat m.Nowy Sącz";1925;1020;905;260;549;467;507;
1262011;"Nowy Sącz (1)";1925;1020;905;260;549;467;507;
1263000;"Powiat m.Tarnów";2981;1686;1295;294;640;807;1347;
1263011;"Tarnów (1)";2981;1686;1295;294;640;807;1347;
1400000;"MAZOWIECKIE";143052;72625;70427;17369;36928;36774;69227;
1401000;"Powiat białobrzeski";1212;539;673;217;414;295;592;
1401013;"Białobrzegi (3)";393;183;210;47;98;105;184;
1401014;"Białobrzegi - miasto (4)";246;120;126;34;62;65;105;
1401015;"Białobrzegi - obszar wiejski (5)";147;63;84;13;36;40;79;
1401022;"Promna (2)";152;66;86;34;59;38;72;
1401032;"Radzanów (2)";118;52;66;34;53;17;64;
1401042;"Stara Błotnica (2)";201;94;107;41;86;41;93;
1401052;"Stromiec (2)";236;101;135;44;85;54;112;
1401063;"Wyśmierzyce (3)";112;43;69;17;33;40;67;
1401064;"Wyśmierzyce - miasto (4)";38;15;23;3;8;18;24;
1401065;"Wyśmierzyce - obszar wiejski (5)";74;28;46;14;25;22;43;
1402000;"Powiat ciechanowski";3324;1687;1637;444;939;872;1634;
1402011;"Ciechanów (1)";1687;842;845;174;415;436;833;
1402022;"Ciechanów (2)";226;114;112;31;71;59;107;
1402033;"Glinojeck (3)";296;149;147;43;83;85;143;
1402034;"Glinojeck - miasto (4)";95;47;48;11;26;24;46;
1402035;"Glinojeck - obszar wiejski (5)";201;102;99;32;57;61;97;
1402042;"Gołymin-Ośrodek (2)";151;75;76;29;49;36;81;
1402052;"Grudusk (2)";121;68;53;12;39;36;66;
1402062;"Ojrzeń (2)";172;97;75;32;61;47;86;
1402072;"Opinogóra Górna (2)";195;101;94;30;59;49;112;
1402082;"Regimin (2)";234;114;120;40;67;68;96;
1402092;"Sońsk (2)";242;127;115;53;95;56;110;
1403000;"Powiat garwoliński";4007;1834;2173;659;1332;902;2123;
1403011;"Garwolin (1)";713;354;359;87;191;165;390;
1403021;"Łaskarzew (1)";213;106;107;27;54;56;118;
1403032;"Borowie (2)";199;75;124;35;74;42;106;
1403042;"Garwolin (2)";512;230;282;75;169;109;287;
1403052;"Górzno (2)";239;101;138;44;103;40;111;
1403062;"Łaskarzew (2)";204;103;101;33;74;45;109;
1403072;"Maciejowice (2)";263;132;131;35;79;69;148;
1403082;"Miastków Kościelny (2)";154;71;83;36;62;35;75;
1403092;"Parysów (2)";142;66;76;31;53;29;77;
1403103;"Pilawa (3)";425;185;240;60;128;102;226;
1403104;"Pilawa - miasto (4)";171;84;87;27;52;41;89;
1403105;"Pilawa - obszar wiejski (5)";254;101;153;33;76;61;137;
1403112;"Sobolew (2)";210;88;122;43;78;41;82;
1403122;"Trojanów (2)";187;83;104;44;75;28;94;
1403132;"Wilga (2)";177;65;112;38;69;52;98;
1403143;"Żelechów (3)";369;175;194;71;123;89;202;
1403144;"Żelechów - miasto (4)";114;57;57;21;37;33;64;
1403145;"Żelechów - obszar wiejski (5)";255;118;137;50;86;56;138;
1404000;"Powiat gostyniński";2160;1172;988;275;566;596;1154;
1404011;"Gostynin (1)";830;452;378;104;205;241;414;
1404022;"Gostynin (2)";674;374;300;77;168;199;357;
1404032;"Pacyna (2)";153;79;74;11;40;38;90;
1404043;"Sanniki (3)";230;122;108;40;75;44;137;
1404044;"Sanniki - miasto (4)";80;43;37;10;16;23;47;
1404045;"Sanniki - obszar wiejski (5)";150;79;71;30;59;21;90;
1404052;"Szczawin Kościelny (2)";273;145;128;43;78;74;156;
1405000;"Powiat grodziski";1320;707;613;155;337;354;400;
1405011;"Milanówek (1)";210;108;102;14;33;76;60;
1405021;"Podkowa Leśna (1)";41;17;24;4;12;11;6;
1405032;"Baranów (2)";70;35;35;10;20;13;22;
1405043;"Grodzisk Mazowiecki (3)";703;392;311;96;193;173;220;
1405044;"Grodzisk Mazowiecki - miasto (4)";492;274;218;70;136;115;160;
1405045;"Grodzisk Mazowiecki - obszar wiejski (5)";211;118;93;26;57;58;60;
1405052;"Jaktorów (2)";166;84;82;18;48;38;45;
1405062;"Żabia Wola (2)";130;71;59;13;31;43;47;
1406000;"Powiat grójecki";1278;669;609;236;440;308;405;
1406012;"Belsk Duży (2)";49;25;24;8;19;10;10;
1406022;"Błędów (2)";75;44;31;23;37;16;22;
1406032;"Chynów (2)";111;58;53;21;42;30;49;
1406042;"Goszczyn (2)";27;11;16;4;6;9;11;
1406053;"Grójec (3)";401;204;197;66;116;100;114;
1406054;"Grójec - miasto (4)";259;134;125;31;62;65;68;
1406055;"Grójec - obszar wiejski (5)";142;70;72;35;54;35;46;
1406062;"Jasieniec (2)";55;27;28;12;25;12;21;
1406073;"Mogielnica (3)";104;57;47;25;41;21;30;
1406074;"Mogielnica - miasto (4)";37;17;20;4;10;5;11;
1406075;"Mogielnica - obszar wiejski (5)";67;40;27;21;31;16;19;
1406083;"Nowe Miasto nad Pilicą (3)";107;55;52;15;32;29;38;
1406084;"Nowe Miasto nad Pilicą - miasto (4)";60;31;29;6;15;16;20;
1406085;"Nowe Miasto nad Pilicą - obszar wiejski (5)";47;24;23;9;17;13;18;
1406092;"Pniewy (2)";58;35;23;13;24;13;20;
1406113;"Warka (3)";291;153;138;49;98;68;90;
1406114;"Warka - miasto (4)";198;107;91;29;63;44;60;
1406115;"Warka - obszar wiejski (5)";93;46;47;20;35;24;30;
1407000;"Powiat kozienicki";2494;1369;1125;288;626;629;1551;
1407012;"Garbatka-Letnisko (2)";283;161;122;28;63;88;188;
1407022;"Głowaczów (2)";348;180;168;45;99;94;226;
1407032;"Gniewoszów (2)";158;86;72;24;54;39;102;
1407042;"Grabów nad Pilicą (2)";148;62;86;17;43;35;89;
1407053;"Kozienice (3)";1171;683;488;118;252;280;718;
1407054;"Kozienice - miasto (4)";606;352;254;52;107;131;371;
1407055;"Kozienice - obszar wiejski (5)";565;331;234;66;145;149;347;
1407062;"Magnuszew (2)";227;108;119;35;75;51;140;
1407072;"Sieciechów (2)";159;89;70;21;40;42;88;
1408000;"Powiat legionowski";2623;1286;1337;281;565;705;1124;
1408011;"Legionowo (1)";1185;551;634;111;223;321;526;
1408022;"Jabłonna (2)";392;201;191;41;93;113;161;
1408032;"Nieporęt (2)";251;136;115;26;50;59;105;
1408043;"Serock (3)";419;195;224;57;109;106;176;
1408044;"Serock - miasto (4)";141;58;83;20;39;40;64;
1408045;"Serock - obszar wiejski (5)";278;137;141;37;70;66;112;
1408052;"Wieliszew (2)";376;203;173;46;90;106;156;
1409000;"Powiat lipski";1631;783;848;293;580;360;948;
1409012;"Chotcza (2)";128;63;65;19;41;36;72;
1409022;"Ciepielów (2)";292;150;142;69;124;49;165;
1409033;"Lipsko (3)";485;225;260;67;147;129;290;
1409034;"Lipsko - miasto (4)";207;87;120;24;61;65;117;
1409035;"Lipsko - obszar wiejski (5)";278;138;140;43;86;64;173;
1409042;"Rzeczniów (2)";161;75;86;31;56;40;85;
1409052;"Sienno (2)";286;137;149;48;104;55;172;
1409062;"Solec nad Wisłą (2)";279;133;146;59;108;51;164;
1410000;"Powiat łosicki";738;354;384;119;242;159;365;
1410012;"Huszlew (2)";56;33;23;8;22;12;30;
1410023;"Łosice (3)";284;135;149;45;87;58;127;
1410024;"Łosice - miasto (4)";181;85;96;30;51;40;80;
1410025;"Łosice - obszar wiejski (5)";103;50;53;15;36;18;47;
1410032;"Olszanka (2)";48;29;19;10;18;7;25;
1410042;"Platerów (2)";118;46;72;21;41;24;57;
1410052;"Sarnaki (2)";135;65;70;20;43;34;66;
1410062;"Stara Kornica (2)";97;46;51;15;31;24;60;
1411000;"Powiat makowski";2878;1375;1503;540;984;569;1922;
1411011;"Maków Mazowiecki (1)";637;318;319;70;153;148;413;
1411022;"Czerwonka (2)";176;79;97;29;73;33;122;
1411032;"Karniewo (2)";307;141;166;66;133;53;184;
1411042;"Krasnosielc (2)";444;208;236;95;152;92;311;
1411052;"Młynarze (2)";86;38;48;20;34;12;58;
1411062;"Płoniawy-Bramura (2)";367;183;184;73;126;84;259;
1411073;"Różan (3)";289;138;151;42;80;59;192;
1411074;"Różan - miasto (4)";198;90;108;27;57;42;129;
1411075;"Różan - obszar wiejski (5)";91;48;43;15;23;17;63;
1411082;"Rzewnie (2)";159;86;73;49;75;23;108;
1411092;"Sypniewo (2)";184;75;109;42;69;35;120;
1411102;"Szelków (2)";229;109;120;54;89;30;155;
1412000;"Powiat miński";2972;1502;1470;377;765;835;1339;
1412011;"Mińsk Mazowiecki (1)";907;477;430;96;193;252;410;
1412042;"Cegłów (2)";124;51;73;16;32;30;54;
1412052;"Dębe Wielkie (2)";214;111;103;31;60;61;92;
1412062;"Dobre (2)";104;58;46;17;35;18;49;
1412073;"Halinów (3)";296;142;154;30;72;90;133;
1412074;"Halinów - miasto (4)";65;30;35;10;21;20;29;
1412075;"Halinów - obszar wiejski (5)";231;112;119;20;51;70;104;
1412082;"Jakubów (2)";105;65;40;19;37;31;50;
1412093;"Kałuszyn (3)";119;61;58;21;35;31;60;
1412094;"Kałuszyn - miasto (4)";61;30;31;6;15;15;32;
1412095;"Kałuszyn - obszar wiejski (5)";58;31;27;15;20;16;28;
1412102;"Latowicz (2)";89;47;42;19;35;21;43;
1412112;"Mińsk Mazowiecki (2)";306;142;164;45;85;96;131;
1412123;"Mrozy (3)";161;81;80;28;48;45;74;
1412124;"Mrozy - miasto (4)";67;30;37;11;19;18;23;
1412125;"Mrozy - obszar wiejski (5)";94;51;43;17;29;27;51;
1412132;"Siennica (2)";130;58;72;20;36;38;64;
1412142;"Stanisławów (2)";131;66;65;24;45;32;58;
1412151;"Sulejówek (1)";286;143;143;11;52;90;121;
1413000;"Powiat mławski";2014;1160;854;278;578;519;805;
1413011;"Mława (1)";926;534;392;101;233;248;363;
1413022;"Dzierzgowo (2)";79;47;32;18;25;20;40;
1413032;"Lipowiec Kościelny (2)";138;80;58;29;46;43;46;
1413042;"Radzanów (2)";94;51;43;12;27;33;41;
1413052;"Strzegowo (2)";185;100;85;26;60;45;86;
1413062;"Stupsk (2)";119;75;44;20;40;28;50;
1413072;"Szreńsk (2)";114;67;47;19;41;23;53;
1413082;"Szydłowo (2)";127;73;54;11;32;30;47;
1413092;"Wieczfnia Kościelna (2)";92;44;48;16;32;19;23;
1413102;"Wiśniewo (2)";140;89;51;26;42;30;56;
1414000;"Powiat nowodworski";2138;1076;1062;276;526;524;1023;
1414011;"Nowy Dwór Mazowiecki (1)";728;372;356;89;172;165;331;
1414022;"Czosnów (2)";203;108;95;11;33;58;106;
1414032;"Leoncin (2)";121;58;63;21;35;25;47;
1414043;"Nasielsk (3)";673;335;338;99;186;164;327;
1414044;"Nasielsk - miasto (4)";257;130;127;42;75;56;113;
1414045;"Nasielsk - obszar wiejski (5)";416;205;211;57;111;108;214;
1414052;"Pomiechówek (2)";234;117;117;37;63;57;110;
1414063;"Zakroczym (3)";179;86;93;19;37;55;102;
1414064;"Zakroczym - miasto (4)";89;40;49;10;16;28;45;
1414065;"Zakroczym - obszar wiejski (5)";90;46;44;9;21;27;57;
1415000;"Powiat ostrołęcki";3320;1749;1571;536;1116;799;1714;
1415012;"Baranowo (2)";261;119;142;36;86;63;161;
1415022;"Czarnia (2)";77;41;36;14;36;10;36;
1415032;"Czerwin (2)";104;51;53;18;41;23;45;
1415042;"Goworowo (2)";294;148;146;55;101;71;164;
1415052;"Kadzidło (2)";319;189;130;50;108;82;143;
1415062;"Lelis (2)";445;252;193;73;149;103;216;
1415072;"Łyse (2)";319;168;151;60;124;71;184;
1415083;"Myszyniec (3)";438;244;194;81;157;108;207;
1415084;"Myszyniec - miasto (4)";185;96;89;18;50;61;93;
1415085;"Myszyniec - obszar wiejski (5)";253;148;105;63;107;47;114;
1415092;"Olszewo-Borki (2)";512;247;265;72;140;117;296;
1415102;"Rzekuń (2)";405;210;195;49;115;108;192;
1415112;"Troszyn (2)";146;80;66;28;59;43;70;
1416000;"Powiat ostrowski";2829;1521;1308;491;954;595;1399;
1416011;"Ostrów Mazowiecka (1)";1077;589;488;159;318;227;528;
1416022;"Andrzejewo (2)";80;36;44;23;45;7;33;
1416032;"Boguty-Pianki (2)";56;32;24;14;24;6;30;
1416043;"Brok (3)";115;57;58;21;40;29;54;
1416044;"Brok - miasto (4)";81;38;43;14;27;22;37;
1416045;"Brok - obszar wiejski (5)";34;19;15;7;13;7;17;
1416052;"Małkinia Górna (2)";407;211;196;65;123;96;198;
1416062;"Nur (2)";69;28;41;11;24;22;44;
1416072;"Ostrów Mazowiecka (2)";575;324;251;111;190;120;290;
1416082;"Stary Lubotyń (2)";121;67;54;33;55;21;54;
1416092;"Szulborze Wielkie (2)";48;24;24;5;22;12;22;
1416102;"Wąsewo (2)";143;73;70;23;59;26;74;
1416112;"Zaręby Kościelne (2)";138;80;58;26;54;29;72;
1417000;"Powiat otwocki";2189;1023;1166;230;496;657;872;
1417011;"Józefów (1)";325;176;149;31;73;96;136;
1417021;"Otwock (1)";861;380;481;77;169;290;373;
1417032;"Celestynów (2)";218;92;126;27;55;61;83;
1417043;"Karczew (3)";304;140;164;25;62;86;115;
1417044;"Karczew - miasto (4)";181;85;96;11;33;56;75;
1417045;"Karczew - obszar wiejski (5)";123;55;68;14;29;30;40;
1417052;"Kołbiel (2)";102;52;50;18;35;30;37;
1417062;"Osieck (2)";75;34;41;14;28;13;28;
1417072;"Sobienie-Jeziory (2)";91;53;38;13;24;19;33;
1417082;"Wiązowna (2)";213;96;117;25;50;62;67;
1418000;"Powiat piaseczyński";3500;1649;1851;311;728;1013;1393;
1418013;"Góra Kalwaria (3)";614;287;327;65;136;149;276;
1418014;"Góra Kalwaria - miasto (4)";265;133;132;29;60;64;119;
1418015;"Góra Kalwaria - obszar wiejski (5)";349;154;195;36;76;85;157;
1418023;"Konstancin-Jeziorna (3)";483;201;282;42;84;150;206;
1418024;"Konstancin-Jeziorna - miasto (4)";354;140;214;30;64;110;145;
1418025;"Konstancin-Jeziorna - obszar wiejski (5)";129;61;68;12;20;40;61;
1418032;"Lesznowola (2)";432;218;214;41;92;115;151;
1418043;"Piaseczno (3)";1487;716;771;99;281;446;553;
1418044;"Piaseczno - miasto (4)";904;442;462;43;153;283;341;
1418045;"Piaseczno - obszar wiejski (5)";583;274;309;56;128;163;212;
1418052;"Prażmów (2)";223;97;126;30;63;67;84;
1418063;"Tarczyn (3)";261;130;131;34;72;86;123;
1418064;"Tarczyn - miasto (4)";84;41;43;5;15;34;41;
1418065;"Tarczyn - obszar wiejski (5)";177;89;88;29;57;52;82;
1419000;"Powiat płocki";4309;2584;1725;615;1330;1041;2312;
1419012;"Bielsk (2)";399;251;148;62;132;88;220;
1419022;"Bodzanów (2)";317;181;136;51;100;73;167;
1419032;"Brudzeń Duży (2)";331;194;137;48;101;54;170;
1419042;"Bulkowo (2)";227;160;67;41;79;40;142;
1419053;"Drobin (3)";317;182;135;56;113;70;185;
1419054;"Drobin - miasto (4)";90;45;45;12;25;32;47;
1419055;"Drobin - obszar wiejski (5)";227;137;90;44;88;38;138;
1419063;"Gąbin (3)";417;231;186;55;118;124;226;
1419064;"Gąbin - miasto (4)";136;76;60;18;38;41;75;
1419065;"Gąbin - obszar wiejski (5)";281;155;126;37;80;83;151;
1419072;"Łąck (2)";269;140;129;22;60;85;137;
1419082;"Mała Wieś (2)";203;119;84;34;71;48;101;
1419092;"Nowy Duninów (2)";225;141;84;23;48;75;124;
1419102;"Radzanowo (2)";297;180;117;44;97;73;155;
1419112;"Słubice (2)";170;107;63;25;58;38;90;
1419122;"Słupno (2)";272;164;108;36;79;61;134;
1419132;"Stara Biała (2)";419;276;143;40;108;104;220;
1419142;"Staroźreby (2)";317;191;126;63;122;78;169;
1419153;"Wyszogród (3)";129;67;62;15;44;30;72;
1419154;"Wyszogród - miasto (4)";55;31;24;7;17;11;27;
1419155;"Wyszogród - obszar wiejski (5)";74;36;38;8;27;19;45;
1420000;"Powiat płoński";3460;1975;1485;564;1101;796;1877;
1420011;"Płońsk (1)";999;528;471;111;243;267;561;
1420021;"Raciąż (1)";243;148;95;40;66;68;125;
1420032;"Baboszewo (2)";331;195;136;50;105;65;189;
1420043;"Czerwińsk nad Wisłą (3)";223;136;87;48;88;40;124;
1420044;"Czerwińsk nad Wisłą - miasto (4)";48;27;21;4;14;14;27;
1420045;"Czerwińsk nad Wisłą - obszar wiejski (5)";175;109;66;44;74;26;97;
1420052;"Dzierzążnia (2)";135;79;56;31;58;28;65;
1420062;"Joniec (2)";64;44;20;7;22;12;38;
1420072;"Naruszewo (2)";231;138;93;48;85;44;111;
1420082;"Nowe Miasto (2)";206;109;97;35;65;49;122;
1420092;"Płońsk (2)";397;220;177;68;139;86;208;
1420102;"Raciąż (2)";200;123;77;46;76;47;94;
1420112;"Sochocin (2)";253;143;110;42;83;53;144;
1420122;"Załuski (2)";178;112;66;38;71;37;96;
1421000;"Powiat pruszkowski";2598;1304;1294;193;483;764;1051;
1421011;"Piastów (1)";390;185;205;33;70;128;163;
1421021;"Pruszków (1)";1056;550;506;62;181;297;428;
1421033;"Brwinów (3)";420;201;219;43;89;117;186;
1421034;"Brwinów - miasto (4)";211;99;112;25;45;59;88;
1421035;"Brwinów - obszar wiejski (5)";209;102;107;18;44;58;98;
1421042;"Michałowice (2)";244;127;117;17;52;69;89;
1421052;"Nadarzyn (2)";214;100;114;17;42;67;76;
1421062;"Raszyn (2)";274;141;133;21;49;86;109;
1422000;"Powiat przasnyski";2025;1057;968;332;626;505;1091;
1422011;"Przasnysz (1)";667;343;324;83;177;181;326;
1422023;"Chorzele (3)";362;186;176;63;119;75;214;
1422024;"Chorzele - miasto (4)";102;51;51;9;23;27;52;
1422025;"Chorzele - obszar wiejski (5)";260;135;125;54;96;48;162;
1422032;"Czernice Borowe (2)";134;69;65;17;48;30;63;
1422042;"Jednorożec (2)";329;181;148;63;106;79;196;
1422052;"Krasne (2)";116;67;49;18;26;33;67;
1422062;"Krzynowłoga Mała (2)";98;47;51;18;34;30;57;
1422072;"Przasnysz (2)";319;164;155;70;116;77;168;
1423000;"Powiat przysuski";3324;1511;1813;505;973;863;2172;
1423012;"Borkowice (2)";464;213;251;56;122;129;320;
1423022;"Gielniów (2)";445;214;231;50;108;132;261;
1423032;"Klwów (2)";183;68;115;40;77;34;125;
1423042;"Odrzywół (2)";273;111;162;51;94;65;163;
1423052;"Potworów (2)";271;114;157;75;123;57;191;
1423063;"Przysucha (3)";832;395;437;105;200;236;505;
1423064;"Przysucha - miasto (4)";359;164;195;37;82;103;219;
1423065;"Przysucha - obszar wiejski (5)";473;231;242;68;118;133;286;
1423072;"Rusinów (2)";400;176;224;65;124;105;282;
1423082;"Wieniawa (2)";456;220;236;63;125;105;325;
1424000;"Powiat pułtuski";2807;1449;1358;519;952;577;1572;
1424012;"Gzy (2)";144;73;71;25;55;17;81;
1424022;"Obryte (2)";210;108;102;54;95;31;116;
1424032;"Pokrzywnica (2)";261;121;140;49;99;55;147;
1424043;"Pułtusk (3)";1464;762;702;237;415;353;773;
1424044;"Pułtusk - miasto (4)";1263;668;595;189;331;316;677;
1424045;"Pułtusk - obszar wiejski (5)";201;94;107;48;84;37;96;
1424052;"Świercze (2)";267;143;124;48;86;52;196;
1424062;"Winnica (2)";197;104;93;34;81;27;106;
1424072;"Zatory (2)";264;138;126;72;121;42;153;
1425000;"Powiat radomski";10024;4880;5144;1375;2860;2273;5607;
1425011;"Pionki (1)";1074;547;527;105;247;279;564;
1425022;"Gózd (2)";694;351;343;80;191;144;399;
1425033;"Iłża (3)";1053;482;571;147;291;248;665;
1425034;"Iłża - miasto (4)";315;137;178;38;82;71;203;
1425035;"Iłża - obszar wiejski (5)";738;345;393;109;209;177;462;
1425042;"Jastrzębia (2)";375;187;188;56;115;109;202;
1425052;"Jedlińsk (2)";744;356;388;123;242;136;359;
1425062;"Jedlnia-Letnisko (2)";824;388;436;84;196;197;459;
1425072;"Kowala (2)";760;357;403;103;210;167;404;
1425082;"Pionki (2)";776;414;362;96;195;178;452;
1425092;"Przytyk (2)";511;239;272;102;187;106;322;
1425103;"Skaryszew (3)";1012;485;527;171;345;205;540;
1425104;"Skaryszew - miasto (4)";328;160;168;42;91;67;177;
1425105;"Skaryszew - obszar wiejski (5)";684;325;359;129;254;138;363;
1425112;"Wierzbica (2)";857;402;455;99;214;209;549;
1425122;"Wolanów (2)";569;293;276;80;164;123;297;
1425132;"Zakrzew (2)";775;379;396;129;263;172;395;
1426000;"Powiat siedlecki";1500;803;697;252;525;319;612;
1426012;"Domanice (2)";53;28;25;8;17;10;24;
1426022;"Korczew (2)";60;36;24;7;24;12;32;
1426032;"Kotuń (2)";149;94;55;22;52;23;49;
1426042;"Mokobody (2)";66;34;32;18;31;11;26;
1426053;"Mordy (3)";109;56;53;10;30;30;57;
1426054;"Mordy - miasto (4)";48;20;28;3;12;18;26;
1426055;"Mordy - obszar wiejski (5)";61;36;25;7;18;12;31;
1426062;"Paprotnia (2)";35;18;17;7;16;5;18;
1426072;"Przesmyki (2)";62;23;39;10;18;19;33;
1426082;"Siedlce (2)";365;192;173;46;100;78;135;
1426092;"Skórzec (2)";146;80;66;32;60;29;53;
1426102;"Suchożebry (2)";100;53;47;17;39;26;36;
1426112;"Wiśniew (2)";109;56;53;27;46;25;46;
1426122;"Wodynie (2)";92;45;47;15;31;15;39;
1426132;"Zbuczyn (2)";154;88;66;33;61;36;64;
1427000;"Powiat sierpecki";2800;1629;1171;411;876;656;1735;
1427011;"Sierpc (1)";872;460;412;102;219;226;523;
1427022;"Gozdowo (2)";329;204;125;54;114;68;197;
1427032;"Mochowo (2)";431;275;156;70;150;100;292;
1427042;"Rościszewo (2)";237;146;91;42;85;47;146;
1427052;"Sierpc (2)";425;249;176;55;122;107;253;
1427062;"Szczutowo (2)";194;122;72;36;71;39;114;
1427072;"Zawidz (2)";312;173;139;52;115;69;210;
1428000;"Powiat sochaczewski";1945;976;969;300;614;474;776;
1428011;"Sochaczew (1)";922;461;461;113;236;267;387;
1428022;"Brochów (2)";135;64;71;19;41;35;72;
1428032;"Iłów (2)";145;67;78;36;62;22;63;
1428042;"Młodzieszyn (2)";111;55;56;23;46;21;33;
1428052;"Nowa Sucha (2)";123;69;54;20;46;18;43;
1428062;"Rybno (2)";51;25;26;11;26;8;15;
1428072;"Sochaczew (2)";264;129;135;45;88;52;102;
1428082;"Teresin (2)";194;106;88;33;69;51;61;
1429000;"Powiat sokołowski";1487;697;790;286;579;283;659;
1429011;"Sokołów Podlaski (1)";645;283;362;106;220;130;280;
1429022;"Bielany (2)";78;43;35;17;38;12;34;
1429032;"Ceranów (2)";52;27;25;7;19;8;27;
1429042;"Jabłonna Lacka (2)";105;54;51;28;52;15;51;
1429053;"Kosów Lacki (3)";133;65;68;29;56;27;60;
1429054;"Kosów Lacki - miasto (4)";46;22;24;5;14;11;19;
1429055;"Kosów Lacki - obszar wiejski (5)";87;43;44;24;42;16;41;
1429062;"Repki (2)";116;58;58;29;61;24;48;
1429072;"Sabnie (2)";92;46;46;20;32;13;37;
1429082;"Sokołów Podlaski (2)";188;83;105;37;71;40;85;
1429092;"Sterdyń (2)";78;38;40;13;30;14;37;
1430000;"Powiat szydłowiecki";3555;1811;1744;397;880;912;2171;
1430012;"Chlewiska (2)";629;332;297;64;136;199;406;
1430022;"Jastrząb (2)";479;261;218;59;126;131;279;
1430032;"Mirów (2)";402;201;201;49;108;94;215;
1430042;"Orońsko (2)";538;294;244;59;134;116;343;
1430053;"Szydłowiec (3)";1507;723;784;166;376;372;928;
1430054;"Szydłowiec - miasto (4)";804;382;422;86;202;172;458;
1430055;"Szydłowiec - obszar wiejski (5)";703;341;362;80;174;200;470;
1432000;"Powiat warszawski zachodni";1350;615;735;101;227;448;493;
1432013;"Błonie (3)";183;75;108;9;24;70;49;
1432014;"Błonie - miasto (4)";107;42;65;3;12;38;34;
1432015;"Błonie - obszar wiejski (5)";76;33;43;6;12;32;15;
1432022;"Izabelin (2)";156;66;90;15;29;62;65;
1432032;"Kampinos (2)";72;36;36;10;17;23;38;
1432042;"Leszno (2)";129;59;70;8;20;42;55;
1432053;"Łomianki (3)";342;161;181;22;61;119;137;
1432054;"Łomianki - miasto (4)";217;101;116;12;43;73;85;
1432055;"Łomianki - obszar wiejski (5)";125;60;65;10;18;46;52;
1432063;"Ożarów Mazowiecki (3)";288;140;148;23;47;70;77;
1432064;"Ożarów Mazowiecki - miasto (4)";135;62;73;12;25;36;35;
1432065;"Ożarów Mazowiecki - obszar wiejski (5)";153;78;75;11;22;34;42;
1432072;"Stare Babice (2)";180;78;102;14;29;62;72;
1433000;"Powiat węgrowski";1861;937;924;316;617;419;804;
1433011;"Węgrów (1)";393;188;205;53;120;105;160;
1433022;"Grębków (2)";86;43;43;19;35;14;34;
1433032;"Korytnica (2)";127;67;60;32;55;22;60;
1433042;"Liw (2)";227;123;104;47;82;52;104;
1433053;"Łochów (3)";555;267;288;77;159;118;237;
1433054;"Łochów - miasto (4)";207;98;109;31;64;42;76;
1433055;"Łochów - obszar wiejski (5)";348;169;179;46;95;76;161;
1433062;"Miedzna (2)";82;46;36;22;37;18;25;
1433072;"Sadowne (2)";191;103;88;39;63;38;85;
1433082;"Stoczek (2)";142;71;71;17;45;39;73;
1433092;"Wierzbno (2)";58;29;29;10;21;13;26;
1434000;"Powiat wołomiński";6331;3191;3140;740;1543;1536;2713;
1434011;"Kobyłka (1)";604;323;281;59;129;168;307;
1434021;"Marki (1)";739;408;331;70;169;162;242;
1434031;"Ząbki (1)";561;303;258;28;93;149;225;
1434041;"Zielonka (1)";417;201;216;40;82;112;188;
1434052;"Dąbrówka (2)";189;95;94;28;66;36;63;
1434062;"Jadów (2)";331;158;173;43;90;75;188;
1434072;"Klembów (2)";319;161;158;42;101;61;147;
1434082;"Poświętne (2)";168;83;85;29;49;37;64;
1434093;"Radzymin (3)";712;367;345;91;178;180;258;
1434094;"Radzymin - miasto (4)";309;167;142;38;77;78;124;
1434095;"Radzymin - obszar wiejski (5)";403;200;203;53;101;102;134;
1434102;"Strachówka (2)";69;33;36;16;28;12;24;
1434113;"Tłuszcz (3)";719;319;400;122;220;169;306;
1434114;"Tłuszcz - miasto (4)";265;125;140;47;81;67;99;
1434115;"Tłuszcz - obszar wiejski (5)";454;194;260;75;139;102;207;
1434123;"Wołomin (3)";1503;740;763;172;338;375;701;
1434124;"Wołomin - miasto (4)";1077;534;543;100;215;270;522;
1434125;"Wołomin - obszar wiejski (5)";426;206;220;72;123;105;179;
1435000;"Powiat wyszkowski";1555;819;736;383;651;313;374;
1435012;"Brańszczyk (2)";160;88;72;49;72;31;39;
1435022;"Długosiodło (2)";184;103;81;48;88;33;50;
1435032;"Rząśnik (2)";134;67;67;43;65;22;23;
1435042;"Somianka (2)";104;52;52;32;54;21;34;
1435053;"Wyszków (3)";879;456;423;189;336;181;205;
1435054;"Wyszków - miasto (4)";612;307;305;126;224;124;137;
1435055;"Wyszków - obszar wiejski (5)";267;149;118;63;112;57;68;
1435062;"Zabrodzie (2)";94;53;41;22;36;25;23;
1436000;"Powiat zwoleński";1608;788;820;274;540;368;819;
1436012;"Kazanów (2)";221;99;122;47;74;56;109;
1436022;"Policzna (2)";242;130;112;35;78;60;133;
1436032;"Przyłęk (2)";217;103;114;35;75;53;95;
1436042;"Tczów (2)";222;109;113;42;89;36;110;
1436053;"Zwoleń (3)";706;347;359;115;224;163;372;
1436054;"Zwoleń - miasto (4)";358;177;181;41;94;85;194;
1436055;"Zwoleń - obszar wiejski (5)";348;170;178;74;130;78;178;
1437000;"Powiat żuromiński";2514;1350;1164;407;793;572;1481;
1437013;"Bieżuń (3)";295;146;149;50;86;65;177;
1437014;"Bieżuń - miasto (4)";139;68;71;14;28;42;84;
1437015;"Bieżuń - obszar wiejski (5)";156;78;78;36;58;23;93;
1437022;"Kuczbork-Osada (2)";362;204;158;49;110;78;211;
1437033;"Lubowidz (3)";472;246;226;94;164;107;269;
1437034;"Lubowidz - miasto (4)";102;50;52;12;26;27;59;
1437035;"Lubowidz - obszar wiejski (5)";370;196;174;82;138;80;210;
1437042;"Lutocin (2)";221;131;90;49;99;32;135;
1437052;"Siemiątkowo (2)";222;108;114;47;86;45;140;
1437063;"Żuromin (3)";942;515;427;118;248;245;549;
1437064;"Żuromin - miasto (4)";560;300;260;51;113;153;340;
1437065;"Żuromin - obszar wiejski (5)";382;215;167;67;135;92;209;
1438000;"Powiat żyrardowski";2750;1330;1420;312;686;704;1604;
1438011;"Żyrardów (1)";1444;694;750;146;322;381;826;
1438023;"Mszczonów (3)";347;186;161;47;108;67;206;
1438024;"Mszczonów - miasto (4)";171;86;85;21;48;36;99;
1438025;"Mszczonów - obszar wiejski (5)";176;100;76;26;60;31;107;
1438032;"Puszcza Mariańska (2)";322;160;162;30;77;80;200;
1438042;"Radziejowice (2)";198;95;103;20;46;50;112;
1438052;"Wiskitki (2)";439;195;244;69;133;126;260;
1461000;"Powiat m.Ostrołęka";2291;1232;1059;215;494;637;1265;
1461011;"Ostrołęka (1)";2291;1232;1059;215;494;637;1265;
1462000;"Powiat m.Płock";4481;2674;1807;418;985;1193;2340;
1462011;"Płock (1)";4481;2674;1807;418;985;1193;2340;
1463000;"Powiat m.Radom";11522;5609;5913;1054;2408;3163;6326;
1463011;"Radom (1)";11522;5609;5913;1054;2408;3163;6326;
1464000;"Powiat m.Siedlce";1686;903;783;131;375;432;726;
1464011;"Siedlce (1)";1686;903;783;131;375;432;726;
1465000;"Powiat m. st. Warszawa";22642;11046;11596;1263;3622;6835;7884;
1465011;"M.st.Warszawa od 2002 (1)";22642;11046;11596;1263;3622;6835;7884;
1600000;"OPOLSKIE";24999;13818;11181;3045;6482;7179;10799;
1601000;"Powiat brzeski";2553;1446;1107;316;657;695;1058;
1601011;"Brzeg (1)";1028;574;454;98;244;282;433;
1601022;"Skarbimierz (2)";214;119;95;33;72;57;82;
1601033;"Grodków (3)";561;322;239;77;145;152;240;
1601034;"Grodków - miasto (4)";234;125;109;27;55;66;88;
1601035;"Grodków - obszar wiejski (5)";327;197;130;50;90;86;152;
1601043;"Lewin Brzeski (3)";362;212;150;54;97;103;167;
1601044;"Lewin Brzeski - miasto (4)";150;92;58;25;40;46;62;
1601045;"Lewin Brzeski - obszar wiejski (5)";212;120;92;29;57;57;105;
1601052;"Lubsza (2)";260;150;110;34;69;69;87;
1601062;"Olszanka (2)";128;69;59;20;30;32;49;
1602000;"Powiat głubczycki";1652;853;799;227;442;496;778;
1602013;"Baborów (3)";222;131;91;30;62;59;111;
1602014;"Baborów - miasto (4)";114;69;45;13;27;30;63;
1602015;"Baborów - obszar wiejski (5)";108;62;46;17;35;29;48;
1602022;"Branice (2)";199;96;103;27;54;61;97;
1602033;"Głubczyce (3)";862;444;418;119;230;231;405;
1602034;"Głubczyce - miasto (4)";517;249;268;67;137;132;249;
1602035;"Głubczyce - obszar wiejski (5)";345;195;150;52;93;99;156;
1602043;"Kietrz (3)";369;182;187;51;96;145;165;
1602044;"Kietrz - miasto (4)";216;108;108;27;60;83;99;
1602045;"Kietrz - obszar wiejski (5)";153;74;79;24;36;62;66;
1603000;"Powiat kędzierzyńsko-kozielski";2648;1584;1064;315;686;769;1399;
1603011;"Kędzierzyn-Koźle (1)";1758;1025;733;187;421;511;927;
1603022;"Bierawa (2)";201;130;71;23;60;52;111;
1603032;"Cisek (2)";111;77;34;24;40;26;55;
1603042;"Pawłowiczki (2)";217;133;84;28;62;68;121;
1603052;"Polska Cerekiew (2)";123;73;50;19;38;38;69;
1603062;"Reńska Wieś (2)";238;146;92;34;65;74;116;
1604000;"Powiat kluczborski";1753;1028;725;244;468;430;853;
1604013;"Byczyna (3)";288;191;97;43;79;66;135;
1604014;"Byczyna - miasto (4)";78;52;26;11;19;14;28;
1604015;"Byczyna - obszar wiejski (5)";210;139;71;32;60;52;107;
1604023;"Kluczbork (3)";904;508;396;132;242;215;401;
1604024;"Kluczbork - miasto (4)";648;342;306;92;167;166;281;
1604025;"Kluczbork - obszar wiejski (5)";256;166;90;40;75;49;120;
1604032;"Lasowice Wielkie (2)";125;86;39;14;35;31;64;
1604043;"Wołczyn (3)";436;243;193;55;112;118;253;
1604044;"Wołczyn - miasto (4)";188;98;90;19;41;49;111;
1604045;"Wołczyn - obszar wiejski (5)";248;145;103;36;71;69;142;
1605000;"Powiat krapkowicki";1697;1077;620;215;490;449;795;
1605013;"Gogolin (3)";316;202;114;41;97;81;161;
1605014;"Gogolin - miasto (4)";195;126;69;27;63;47;107;
1605015;"Gogolin - obszar wiejski (5)";121;76;45;14;34;34;54;
1605023;"Krapkowice (3)";656;390;266;82;181;190;306;
1605024;"Krapkowice - miasto (4)";509;300;209;63;137;149;224;
1605025;"Krapkowice - obszar wiejski (5)";147;90;57;19;44;41;82;
1605032;"Strzeleczki (2)";223;152;71;31;69;68;118;
1605042;"Walce (2)";122;83;39;21;45;25;49;
1605053;"Zdzieszowice (3)";380;250;130;40;98;85;161;
1605054;"Zdzieszowice - miasto (4)";294;192;102;31;81;59;119;
1605055;"Zdzieszowice - obszar wiejski (5)";86;58;28;9;17;26;42;
1606000;"Powiat namysłowski";1197;725;472;185;368;340;601;
1606012;"Domaszowice (2)";107;65;42;18;38;29;60;
1606023;"Namysłów (3)";695;439;256;111;212;184;344;
1606024;"Namysłów - miasto (4)";426;259;167;60;117;117;207;
1606025;"Namysłów - obszar wiejski (5)";269;180;89;51;95;67;137;
1606032;"Pokój (2)";154;90;64;16;44;54;84;
1606042;"Świerczów (2)";120;69;51;19;34;43;57;
1606052;"Wilków (2)";121;62;59;21;40;30;56;
1607000;"Powiat nyski";3802;1996;1806;400;880;1179;1425;
1607013;"Głuchołazy (3)";803;386;417;63;151;283;318;
1607014;"Głuchołazy - miasto (4)";478;219;259;33;84;166;177;
1607015;"Głuchołazy - obszar wiejski (5)";325;167;158;30;67;117;141;
1607022;"Kamiennik (2)";124;61;63;11;26;42;62;
1607033;"Korfantów (3)";225;116;109;19;51;81;102;
1607034;"Korfantów - miasto (4)";40;18;22;2;8;16;21;
1607035;"Korfantów - obszar wiejski (5)";185;98;87;17;43;65;81;
1607042;"Łambinowice (2)";183;93;90;23;37;65;70;
1607053;"Nysa (3)";1369;758;611;150;338;368;421;
1607054;"Nysa - miasto (4)";1054;592;462;107;256;285;320;
1607055;"Nysa - obszar wiejski (5)";315;166;149;43;82;83;101;
1607063;"Otmuchów (3)";394;211;183;52;105;123;148;
1607064;"Otmuchów - miasto (4)";159;82;77;14;36;51;56;
1607065;"Otmuchów - obszar wiejski (5)";235;129;106;38;69;72;92;
1607073;"Paczków (3)";449;236;213;45;103;139;191;
1607074;"Paczków - miasto (4)";280;146;134;31;71;83;120;
1607075;"Paczków - obszar wiejski (5)";169;90;79;14;32;56;71;
1607082;"Pakosławice (2)";108;61;47;12;26;33;50;
1607092;"Skoroszyce (2)";147;74;73;25;43;45;63;
1608000;"Powiat oleski";1204;700;504;162;340;349;500;
1608013;"Dobrodzień (3)";147;93;54;29;43;43;62;
1608014;"Dobrodzień - miasto (4)";55;32;23;12;18;16;25;
1608015;"Dobrodzień - obszar wiejski (5)";92;61;31;17;25;27;37;
1608023;"Gorzów Śląski (3)";137;81;56;27;46;35;63;
1608024;"Gorzów Śląski - miasto (4)";51;29;22;13;17;16;19;
1608025;"Gorzów Śląski - obszar wiejski (5)";86;52;34;14;29;19;44;
1608033;"Olesno (3)";308;179;129;33;79;92;117;
1608034;"Olesno - miasto (4)";173;93;80;12;35;57;62;
1608035;"Olesno - obszar wiejski (5)";135;86;49;21;44;35;55;
1608043;"Praszka (3)";275;162;113;36;73;81;113;
1608044;"Praszka - miasto (4)";167;104;63;21;43;50;70;
1608045;"Praszka - obszar wiejski (5)";108;58;50;15;30;31;43;
1608052;"Radłów (2)";73;42;31;4;19;27;31;
1608062;"Rudniki (2)";189;96;93;23;54;52;71;
1608072;"Zębowice (2)";75;47;28;10;26;19;43;
1609000;"Powiat opolski";2508;1301;1207;302;644;758;943;
1609012;"Chrząstowice (2)";127;58;69;14;29;40;46;
1609022;"Dąbrowa (2)";192;95;97;17;48;54;72;
1609032;"Dobrzeń Wielki (2)";150;92;58;24;51;35;49;
1609042;"Komprachcice (2)";163;88;75;18;40;53;76;
1609052;"Łubniany (2)";191;99;92;19;48;50;82;
1609062;"Murów (2)";136;84;52;17;47;37;68;
1609073;"Niemodlin (3)";350;174;176;53;91;129;122;
1609074;"Niemodlin - miasto (4)";165;81;84;23;46;54;53;
1609075;"Niemodlin - obszar wiejski (5)";185;93;92;30;45;75;69;
1609083;"Ozimek (3)";380;170;210;38;82;122;148;
1609084;"Ozimek - miasto (4)";190;83;107;18;47;57;72;
1609085;"Ozimek - obszar wiejski (5)";190;87;103;20;35;65;76;
1609092;"Popielów (2)";168;90;78;24;41;58;59;
1609103;"Prószków (3)";147;73;74;14;35;39;54;
1609104;"Prószków - miasto (4)";46;20;26;4;8;16;17;
1609105;"Prószków - obszar wiejski (5)";101;53;48;10;27;23;37;
1609112;"Tarnów Opolski (2)";189;121;68;27;61;54;63;
1609123;"Tułowice (3)";126;60;66;19;29;31;30;
1609124;"Tułowice - miasto (4)";84;44;40;16;23;16;16;
1609125;"Tułowice - obszar wiejski (5)";42;16;26;3;6;15;14;
1609132;"Turawa (2)";189;97;92;18;42;56;74;
1610000;"Powiat prudnicki";1706;892;814;232;483;478;796;
1610013;"Biała (3)";220;119;101;29;58;71;100;
1610014;"Biała - miasto (4)";69;34;35;9;13;21;36;
1610015;"Biała - obszar wiejski (5)";151;85;66;20;45;50;64;
1610023;"Głogówek (3)";275;155;120;37;82;78;124;
1610024;"Głogówek - miasto (4)";157;93;64;20;48;45;78;
1610025;"Głogówek - obszar wiejski (5)";118;62;56;17;34;33;46;
1610032;"Lubrza (2)";143;76;67;19;38;46;68;
1610043;"Prudnik (3)";1068;542;526;147;305;283;504;
1610044;"Prudnik - miasto (4)";848;433;415;109;226;230;411;
1610045;"Prudnik - obszar wiejski (5)";220;109;111;38;79;53;93;
1611000;"Powiat strzelecki";1440;795;645;202;405;423;633;
1611012;"Izbicko (2)";89;51;38;9;22;28;43;
1611022;"Jemielnica (2)";135;79;56;24;38;44;67;
1611033;"Kolonowskie (3)";83;43;40;7;22;30;31;
1611034;"Kolonowskie - miasto (4)";56;29;27;3;13;22;22;
1611035;"Kolonowskie - obszar wiejski (5)";27;14;13;4;9;8;9;
1611043;"Leśnica (3)";132;82;50;19;42;24;66;
1611044;"Leśnica - miasto (4)";53;35;18;7;16;8;26;
1611045;"Leśnica - obszar wiejski (5)";79;47;32;12;26;16;40;
1611053;"Strzelce Opolskie (3)";706;365;341;104;201;208;289;
1611054;"Strzelce Opolskie - miasto (4)";452;233;219;62;122;130;187;
1611055;"Strzelce Opolskie - obszar wiejski (5)";254;132;122;42;79;78;102;
1611063;"Ujazd (3)";107;61;46;17;34;28;48;
1611064;"Ujazd - miasto (4)";20;9;11;6;7;8;11;
1611065;"Ujazd - obszar wiejski (5)";87;52;35;11;27;20;37;
1611073;"Zawadzkie (3)";188;114;74;22;46;61;89;
1611074;"Zawadzkie - miasto (4)";124;79;45;15;32;37;59;
1611075;"Zawadzkie - obszar wiejski (5)";64;35;29;7;14;24;30;
1661000;"Powiat m.Opole";2839;1421;1418;245;619;813;1018;
1661011;"Opole (1)";2839;1421;1418;245;619;813;1018;
1800000;"PODKARPACKIE";86159;45420;40739;11959;25081;19584;45019;
1801000;"Powiat bieszczadzki";1256;668;588;185;383;267;710;
1801032;"Czarna (2)";146;80;66;31;52;35;85;
1801052;"Lutowiska (2)";129;72;57;13;39;36;74;
1801083;"Ustrzyki Dolne (3)";981;516;465;141;292;196;551;
1801084;"Ustrzyki Dolne - miasto (4)";501;274;227;59;119;103;299;
1801085;"Ustrzyki Dolne - obszar wiejski (5)";480;242;238;82;173;93;252;
1802000;"Powiat brzozowski";4406;2380;2026;633;1240;1054;2647;
1802013;"Brzozów (3)";1753;903;850;245;497;419;1061;
1802014;"Brzozów - miasto (4)";363;179;184;41;94;82;223;
1802015;"Brzozów - obszar wiejski (5)";1390;724;666;204;403;337;838;
1802022;"Domaradz (2)";480;290;190;78;145;103;295;
1802032;"Dydnia (2)";633;341;292;93;186;160;382;
1802042;"Haczów (2)";475;288;187;65;123;114;270;
1802052;"Jasienica Rosielna (2)";544;287;257;73;145;133;322;
1802062;"Nozdrzec (2)";521;271;250;79;144;125;317;
1803000;"Powiat dębicki";3515;2065;1450;612;1196;724;1327;
1803011;"Dębica (1)";1238;706;532;150;326;284;500;
1803023;"Brzostek (3)";328;193;135;69;126;63;126;
1803024;"Brzostek - miasto (4)";68;44;24;10;25;14;24;
1803025;"Brzostek - obszar wiejski (5)";260;149;111;59;101;49;102;
1803032;"Czarna (2)";375;221;154;76;148;83;151;
1803042;"Dębica (2)";669;393;276;129;249;124;245;
1803052;"Jodłowa (2)";126;74;52;33;51;27;52;
1803063;"Pilzno (3)";447;279;168;94;171;79;141;
1803064;"Pilzno - miasto (4)";107;67;40;15;31;23;36;
1803065;"Pilzno - obszar wiejski (5)";340;212;128;79;140;56;105;
1803072;"Żyraków (2)";332;199;133;61;125;64;112;
1804000;"Powiat jarosławski";5960;3053;2907;857;1768;1331;3464;
1804011;"Jarosław (1)";1822;879;943;167;408;490;1108;
1804021;"Radymno (1)";277;126;151;35;72;76;163;
1804032;"Chłopice (2)";225;110;115;34;78;37;113;
1804042;"Jarosław (2)";681;357;324;120;224;141;399;
1804052;"Laszki (2)";379;200;179;73;131;79;229;
1804062;"Pawłosiów (2)";390;202;188;54;125;74;217;
1804073;"Pruchnik (3)";559;321;238;97;191;117;336;
1804074;"Pruchnik - miasto (4)";217;129;88;25;56;53;131;
1804075;"Pruchnik - obszar wiejski (5)";342;192;150;72;135;64;205;
1804082;"Radymno (2)";503;264;239;92;167;102;282;
1804092;"Rokietnica (2)";204;116;88;37;71;38;117;
1804102;"Roźwienica (2)";371;198;173;60;115;68;210;
1804112;"Wiązownica (2)";549;280;269;88;186;109;290;
1805000;"Powiat jasielski";5553;3209;2344;682;1479;1198;3176;
1805011;"Jasło (1)";1638;931;707;161;347;402;943;
1805022;"Brzyska (2)";316;195;121;54;102;55;184;
1805032;"Dębowiec (2)";420;240;180;47;122;81;231;
1805042;"Jasło (2)";770;461;309;97;190;169;427;
1805053;"Kołaczyce (3)";519;309;210;82;167;92;279;
1805054;"Kołaczyce - miasto (4)";57;31;26;6;15;9;33;
1805055;"Kołaczyce - obszar wiejski (5)";462;278;184;76;152;83;246;
1805062;"Krempna (2)";100;48;52;18;32;22;60;
1805072;"Nowy Żmigród (2)";427;232;195;53;136;83;266;
1805082;"Osiek Jasielski (2)";264;155;109;37;75;42;155;
1805092;"Skołyszyn (2)";639;379;260;82;185;146;369;
1805112;"Tarnowiec (2)";460;259;201;51;123;106;262;
1806000;"Powiat kolbuszowski";2116;1111;1005;310;678;535;967;
1806012;"Cmolas (2)";316;157;159;54;102;76;136;
1806023;"Kolbuszowa (3)";824;437;387;104;240;225;371;
1806024;"Kolbuszowa - miasto (4)";284;149;135;25;68;71;135;
1806025;"Kolbuszowa - obszar wiejski (5)";540;288;252;79;172;154;236;
1806032;"Majdan Królewski (2)";376;207;169;53;116;108;183;
1806042;"Niwiska (2)";181;96;85;23;63;40;69;
1806052;"Raniżów (2)";205;108;97;28;74;42;104;
1806062;"Dzikowiec (2)";214;106;108;48;83;44;104;
1807000;"Powiat krośnieński";2426;1296;1130;324;676;602;848;
1807012;"Chorkówka (2)";357;203;154;51;108;83;142;
1807023;"Dukla (3)";374;195;179;39;81;98;164;
1807024;"Dukla - miasto (4)";45;26;19;6;12;9;25;
1807025;"Dukla - obszar wiejski (5)";329;169;160;33;69;89;139;
1807033;"Iwonicz-Zdrój (3)";231;120;111;36;73;64;69;
1807034;"Iwonicz-Zdrój - miasto (4)";29;15;14;6;9;8;5;
1807035;"Iwonicz-Zdrój - obszar wiejski (5)";202;105;97;30;64;56;64;
1807043;"Jedlicze (3)";339;179;160;39;75;88;137;
1807044;"Jedlicze - miasto (4)";113;64;49;17;29;32;44;
1807045;"Jedlicze - obszar wiejski (5)";226;115;111;22;46;56;93;
1807052;"Korczyna (2)";222;123;99;29;66;60;77;
1807062;"Krościenko Wyżne (2)";108;63;45;23;38;20;26;
1807072;"Miejsce Piastowe (2)";282;156;126;39;84;59;74;
1807083;"Rymanów (3)";276;124;152;35;78;73;76;
1807084;"Rymanów - miasto (4)";57;22;35;4;12;15;16;
1807085;"Rymanów - obszar wiejski (5)";219;102;117;31;66;58;60;
1807092;"Wojaszówka (2)";196;106;90;25;58;50;68;
1807102;"Jaśliska (2)";41;27;14;8;15;7;15;
1808000;"Powiat leżajski";3764;1991;1773;617;1228;816;2081;
1808011;"Leżajsk (1)";668;331;337;86;187;156;380;
1808022;"Grodzisko Dolne (2)";377;195;182;60;129;78;189;
1808032;"Kuryłówka (2)";329;163;166;69;126;71;184;
1808042;"Leżajsk (2)";1134;603;531;193;407;229;600;
1808053;"Nowa Sarzyna (3)";1256;699;557;209;379;282;728;
1808054;"Nowa Sarzyna - miasto (4)";270;143;127;28;65;64;174;
1808055;"Nowa Sarzyna - obszar wiejski (5)";986;556;430;181;314;218;554;
1809000;"Powiat lubaczowski";2115;955;1160;310;626;550;936;
1809011;"Lubaczów (1)";435;193;242;54;126;110;191;
1809023;"Cieszanów (3)";285;126;159;39;74;93;135;
1809024;"Cieszanów - miasto (4)";95;36;59;8;17;32;42;
1809025;"Cieszanów - obszar wiejski (5)";190;90;100;31;57;61;93;
1809032;"Horyniec-Zdrój (2)";197;83;114;20;47;70;99;
1809042;"Lubaczów (2)";401;183;218;64;119;92;166;
1809053;"Narol (3)";302;150;152;44;79;69;121;
1809054;"Narol - miasto (4)";102;49;53;6;15;28;41;
1809055;"Narol - obszar wiejski (5)";200;101;99;38;64;41;80;
1809063;"Oleszyce (3)";251;110;141;36;78;57;112;
1809064;"Oleszyce - miasto (4)";122;47;75;19;34;21;49;
1809065;"Oleszyce - obszar wiejski (5)";129;63;66;17;44;36;63;
1809072;"Stary Dzików (2)";97;47;50;26;53;17;41;
1809082;"Wielkie Oczy (2)";147;63;84;27;50;42;71;
1810000;"Powiat łańcucki";3462;1740;1722;549;1095;712;1709;
1810011;"Łańcut (1)";706;342;364;86;189;173;342;
1810022;"Białobrzegi (2)";387;195;192;54;125;80;196;
1810032;"Czarna (2)";586;307;279;92;180;117;289;
1810042;"Łańcut (2)";806;394;412;140;267;145;393;
1810052;"Markowa (2)";267;134;133;53;102;52;123;
1810062;"Rakszawa (2)";378;199;179;60;113;88;198;
1810072;"Żołynia (2)";332;169;163;64;119;57;168;
1811000;"Powiat mielecki";3817;1970;1847;567;1084;913;1361;
1811011;"Mielec (1)";1786;893;893;190;394;495;678;
1811022;"Borowa (2)";119;55;64;24;39;27;38;
1811032;"Czermin (2)";169;82;87;48;70;23;62;
1811042;"Gawłuszowice (2)";69;36;33;17;27;10;28;
1811052;"Mielec (2)";376;209;167;51;123;77;115;
1811062;"Padew Narodowa (2)";145;73;72;31;52;26;56;
1811073;"Przecław (3)";378;190;188;49;101;96;140;
1811074;"Przecław - miasto (4)";55;30;25;11;17;10;19;
1811075;"Przecław - obszar wiejski (5)";323;160;163;38;84;86;121;
1811083;"Radomyśl Wielki (3)";342;195;147;68;122;60;101;
1811084;"Radomyśl Wielki - miasto (4)";85;42;43;15;33;17;21;
1811085;"Radomyśl Wielki - obszar wiejski (5)";257;153;104;53;89;43;80;
1811092;"Tuszów Narodowy (2)";254;144;110;44;78;59;93;
1811102;"Wadowice Górne (2)";179;93;86;45;78;40;50;
1812000;"Powiat niżański";3825;2045;1780;536;1190;872;2182;
1812012;"Harasiuki (2)";391;199;192;64;144;64;240;
1812022;"Jarocin (2)";268;151;117;31;81;52;159;
1812032;"Jeżowe (2)";580;285;295;130;239;107;302;
1812042;"Krzeszów (2)";214;114;100;40;75;46;129;
1812053;"Nisko (3)";1207;681;526;128;320;320;682;
1812054;"Nisko - miasto (4)";790;462;328;76;192;209;453;
1812055;"Nisko - obszar wiejski (5)";417;219;198;52;128;111;229;
1812063;"Rudnik nad Sanem (3)";650;324;326;77;161;171;382;
1812064;"Rudnik nad Sanem - miasto (4)";449;220;229;48;109;121;270;
1812065;"Rudnik nad Sanem - obszar wiejski (5)";201;104;97;29;52;50;112;
1812073;"Ulanów (3)";515;291;224;66;170;112;288;
1812074;"Ulanów - miasto (4)";87;56;31;6;19;20;52;
1812075;"Ulanów - obszar wiejski (5)";428;235;193;60;151;92;236;
1813000;"Powiat przemyski";3679;1920;1759;558;1177;808;2123;
1813012;"Bircza (2)";374;192;182;57;124;103;233;
1813022;"Dubiecko (2)";488;241;247;88;182;92;278;
1813032;"Fredropol (2)";262;139;123;34;85;53;165;
1813042;"Krasiczyn (2)";284;135;149;34;67;69;181;
1813052;"Krzywcza (2)";247;131;116;41;85;55;131;
1813062;"Medyka (2)";357;197;160;45;97;80;202;
1813072;"Orły (2)";397;217;180;65;126;71;230;
1813082;"Przemyśl (2)";460;236;224;72;156;99;231;
1813092;"Stubno (2)";200;101;99;31;65;42;126;
1813102;"Żurawica (2)";610;331;279;91;190;144;346;
1814000;"Powiat przeworski";4065;2249;1816;613;1251;828;2376;
1814011;"Przeworsk (1)";783;411;372;74;180;166;488;
1814022;"Adamówka (2)";146;83;63;33;67;27;74;
1814032;"Gać (2)";225;125;100;39;76;49;141;
1814042;"Jawornik Polski (2)";213;122;91;33;69;39;118;
1814053;"Kańczuga (3)";677;356;321;102;205;148;416;
1814054;"Kańczuga - miasto (4)";148;92;56;15;38;28;92;
1814055;"Kańczuga - obszar wiejski (5)";529;264;265;87;167;120;324;
1814062;"Przeworsk (2)";851;476;375;108;229;181;506;
1814073;"Sieniawa (3)";303;172;131;64;114;63;167;
1814074;"Sieniawa - miasto (4)";93;55;38;20;31;21;45;
1814075;"Sieniawa - obszar wiejski (5)";210;117;93;44;83;42;122;
1814082;"Tryńcza (2)";509;303;206;91;173;98;277;
1814092;"Zarzecze (2)";358;201;157;69;138;57;189;
1815000;"Powiat ropczycko-sędziszowski";3616;1937;1679;624;1197;686;1745;
1815012;"Iwierzyce (2)";359;179;180;66;129;61;178;
1815022;"Ostrów (2)";394;222;172;62;117;72;198;
1815033;"Ropczyce (3)";1243;692;551;226;426;227;551;
1815034;"Ropczyce - miasto (4)";718;408;310;108;207;141;316;
1815035;"Ropczyce - obszar wiejski (5)";525;284;241;118;219;86;235;
1815043;"Sędziszów Małopolski (3)";1249;656;593;193;390;248;637;
1815044;"Sędziszów Małopolski - miasto (4)";626;335;291;86;191;119;302;
1815045;"Sędziszów Małopolski - obszar wiejski (5)";623;321;302;107;199;129;335;
1815052;"Wielopole Skrzyńskie (2)";371;188;183;77;135;78;181;
1816000;"Powiat rzeszowski";6467;3332;3135;975;2037;1359;3557;
1816011;"Dynów (1)";361;208;153;41;91;76;240;
1816023;"Błażowa (3)";361;179;182;64;123;79;214;
1816024;"Błażowa - miasto (4)";67;29;38;10;18;13;40;
1816025;"Błażowa - obszar wiejski (5)";294;150;144;54;105;66;174;
1816033;"Boguchwała (3)";711;352;359;96;198;144;371;
1816034;"Boguchwała - miasto (4)";214;101;113;26;54;49;105;
1816035;"Boguchwała - obszar wiejski (5)";497;251;246;70;144;95;266;
1816042;"Chmielnik (2)";244;127;117;28;62;57;123;
1816052;"Dynów (2)";337;175;162;77;138;50;215;
1816063;"Głogów Małopolski (3)";693;340;353;98;223;139;361;
1816064;"Głogów Małopolski - miasto (4)";299;145;154;34;95;61;153;
1816065;"Głogów Małopolski - obszar wiejski (5)";394;195;199;64;128;78;208;
1816072;"Hyżne (2)";284;152;132;52;102;52;140;
1816082;"Kamień (2)";309;161;148;69;115;68;186;
1816092;"Krasne (2)";434;225;209;52;123;105;226;
1816102;"Lubenia (2)";240;124;116;30;65;59;154;
1816113;"Sokołów Małopolski (3)";779;383;396;142;285;152;444;
1816114;"Sokołów Małopolski - miasto (4)";194;100;94;28;58;43;106;
1816115;"Sokołów Małopolski - obszar wiejski (5)";585;283;302;114;227;109;338;
1816122;"Świlcza (2)";611;321;290;78;189;135;340;
1816132;"Trzebownisko (2)";700;376;324;95;208;155;332;
1816143;"Tyczyn (3)";403;209;194;53;115;88;211;
1816144;"Tyczyn - miasto (4)";127;69;58;18;33;29;59;
1816145;"Tyczyn - obszar wiejski (5)";276;140;136;35;82;59;152;
1817000;"Powiat sanocki";3139;1552;1587;451;927;702;1524;
1817011;"Sanok (1)";1186;571;615;124;277;303;603;
1817022;"Besko (2)";154;70;84;20;39;32;70;
1817032;"Bukowsko (2)";155;81;74;37;70;20;73;
1817042;"Komańcza (2)";200;108;92;41;68;44;111;
1817052;"Sanok (2)";620;296;324;87;194;124;283;
1817062;"Tyrawa Wołoska (2)";74;40;34;23;31;17;29;
1817073;"Zagórz (3)";444;228;216;69;141;92;223;
1817074;"Zagórz - miasto (4)";161;84;77;17;37;32;78;
1817075;"Zagórz - obszar wiejski (5)";283;144;139;52;104;60;145;
1817082;"Zarszyn (2)";306;158;148;50;107;70;132;
1818000;"Powiat stalowowolski";2733;1445;1288;368;816;648;993;
1818011;"Stalowa Wola (1)";1627;836;791;197;451;377;598;
1818022;"Bojanów (2)";162;94;68;29;63;33;50;
1818032;"Pysznica (2)";224;124;100;39;76;55;61;
1818042;"Radomyśl nad Sanem (2)";173;94;79;27;55;51;68;
1818053;"Zaklików (3)";250;130;120;34;85;52;108;
1818054;"Zaklików - miasto (4)";83;41;42;5;21;18;39;
1818055;"Zaklików - obszar wiejski (5)";167;89;78;29;64;34;69;
1818062;"Zaleszany (2)";297;167;130;42;86;80;108;
1819000;"Powiat strzyżowski";3741;2010;1731;541;1118;849;2221;
1819012;"Czudec (2)";734;416;318;100;206;172;436;
1819022;"Frysztak (2)";707;405;302;100;198;163;452;
1819032;"Niebylec (2)";657;336;321;97;199;152;399;
1819043;"Strzyżów (3)";1137;576;561;166;347;252;634;
1819044;"Strzyżów - miasto (4)";416;226;190;52;103;84;229;
1819045;"Strzyżów - obszar wiejski (5)";721;350;371;114;244;168;405;
1819052;"Wiśniowa (2)";506;277;229;78;168;110;300;
1820000;"Powiat tarnobrzeski";1784;958;826;272;541;427;801;
1820013;"Baranów Sandomierski (3)";450;234;216;71;139;117;190;
1820014;"Baranów Sandomierski - miasto (4)";31;15;16;1;6;7;20;
1820015;"Baranów Sandomierski - obszar wiejski (5)";419;219;200;70;133;110;170;
1820022;"Gorzyce (2)";480;253;227;68;145;107;210;
1820032;"Grębów (2)";391;215;176;55;109;95;201;
1820043;"Nowa Dęba (3)";463;256;207;78;148;108;200;
1820044;"Nowa Dęba - miasto (4)";267;149;118;42;79;60;123;
1820045;"Nowa Dęba - obszar wiejski (5)";196;107;89;36;69;48;77;
1821000;"Powiat leski";1808;846;962;284;535;428;1115;
1821012;"Baligród (2)";212;104;108;36;74;43;127;
1821022;"Cisna (2)";155;63;92;13;29;43;92;
1821033;"Lesko (3)";698;314;384;108;188;176;427;
1821034;"Lesko - miasto (4)";337;149;188;48;88;78;205;
1821035;"Lesko - obszar wiejski (5)";361;165;196;60;100;98;222;
1821042;"Olszanica (2)";348;193;155;62;117;82;231;
1821052;"Solina (2)";395;172;223;65;127;84;238;
1861000;"Powiat m.Krosno";965;476;489;89;210;245;338;
1861011;"Krosno (1)";965;476;489;89;210;245;338;
1862000;"Powiat m.Przemyśl";3165;1623;1542;259;630;845;1946;
1862011;"Przemyśl (1)";3165;1623;1542;259;630;845;1946;
1863000;"Powiat m.Rzeszów";7181;3737;3444;604;1651;1796;4115;
1863011;"Rzeszów (1)";7181;3737;3444;604;1651;1796;4115;
1864000;"Powiat m.Tarnobrzeg";1601;852;749;139;348;389;757;
1864011;"Tarnobrzeg (1)";1601;852;749;139;348;389;757;
2000000;"PODLASKIE";37280;17515;19765;4773;10432;9738;19269;
2001000;"Powiat augustowski";2254;1081;1173;308;611;624;1307;
2001011;"Augustów (1)";1221;588;633;123;273;365;670;
2001022;"Augustów (2)";217;105;112;50;82;42;120;
2001032;"Bargłów Kościelny (2)";208;111;97;42;69;45;142;
2001043;"Lipsk (3)";209;93;116;39;72;60;117;
2001044;"Lipsk - miasto (4)";112;51;61;12;28;44;61;
2001045;"Lipsk - obszar wiejski (5)";97;42;55;27;44;16;56;
2001052;"Nowinka (2)";93;39;54;14;23;24;56;
2001062;"Płaska (2)";131;65;66;17;34;38;85;
2001072;"Sztabin (2)";175;80;95;23;58;50;117;
2002000;"Powiat białostocki";4609;2124;2485;515;1215;1231;2307;
2002013;"Choroszcz (3)";350;149;201;46;98;81;159;
2002014;"Choroszcz - miasto (4)";117;49;68;16;33;23;48;
2002015;"Choroszcz - obszar wiejski (5)";233;100;133;30;65;58;111;
2002023;"Czarna Białostocka (3)";371;180;191;41;97;116;148;
2002024;"Czarna Białostocka - miasto (4)";312;164;148;31;82;94;124;
2002025;"Czarna Białostocka - obszar wiejski (5)";59;16;43;10;15;22;24;
2002032;"Dobrzyniewo Duże (2)";234;123;111;30;75;53;106;
2002042;"Gródek (2)";225;94;131;23;48;74;121;
2002052;"Juchnowiec Kościelny (2)";461;237;224;50;126;100;211;
2002063;"Łapy (3)";961;429;532;115;251;249;585;
2002064;"Łapy - miasto (4)";728;333;395;79;179;179;446;
2002065;"Łapy - obszar wiejski (5)";233;96;137;36;72;70;139;
2002073;"Michałowo (3)";250;106;144;21;47;85;129;
2002074;"Michałowo - miasto (4)";124;55;69;9;21;37;53;
2002075;"Michałowo - obszar wiejski (5)";126;51;75;12;26;48;76;
2002082;"Poświętne (2)";115;56;59;18;38;31;71;
2002093;"Supraśl (3)";432;177;255;39;105;108;197;
2002094;"Supraśl - miasto (4)";138;50;88;10;31;38;74;
2002095;"Supraśl - obszar wiejski (5)";294;127;167;29;74;70;123;
2002103;"Suraż (3)";71;26;45;7;16;21;41;
2002104;"Suraż - miasto (4)";35;12;23;3;7;10;21;
2002105;"Suraż - obszar wiejski (5)";36;14;22;4;9;11;20;
2002112;"Turośń Kościelna (2)";198;86;112;22;51;60;109;
2002123;"Tykocin (3)";126;54;72;21;44;34;64;
2002124;"Tykocin - miasto (4)";58;25;33;10;21;19;28;
2002125;"Tykocin - obszar wiejski (5)";68;29;39;11;23;15;36;
2002133;"Wasilków (3)";486;256;230;47;116;121;221;
2002134;"Wasilków - miasto (4)";332;178;154;34;83;77;153;
2002135;"Wasilków - obszar wiejski (5)";154;78;76;13;33;44;68;
2002143;"Zabłudów (3)";279;126;153;25;81;88;126;
2002144;"Zabłudów - miasto (4)";81;43;38;6;28;23;39;
2002145;"Zabłudów - obszar wiejski (5)";198;83;115;19;53;65;87;
2002152;"Zawady (2)";50;25;25;10;22;10;19;
2003000;"Powiat bielski";1222;594;628;150;362;336;583;
2003011;"Bielsk Podlaski (1)";668;323;345;65;174;188;286;
2003021;"Brańsk (1)";80;44;36;13;21;19;41;
2003032;"Bielsk Podlaski (2)";128;58;70;14;36;44;73;
2003042;"Boćki (2)";67;30;37;12;23;15;31;
2003052;"Brańsk (2)";69;39;30;11;30;17;39;
2003062;"Orla (2)";59;25;34;7;18;19;26;
2003072;"Rudka (2)";54;29;25;15;26;11;31;
2003082;"Wyszki (2)";97;46;51;13;34;23;56;
2004000;"Powiat grajewski";2150;1033;1117;297;622;530;1154;
2004011;"Grajewo (1)";1112;569;543;128;288;282;622;
2004022;"Grajewo (2)";205;97;108;37;72;48;101;
2004032;"Radziłów (2)";156;69;87;27;43;46;79;
2004043;"Rajgród (3)";226;108;118;43;77;59;125;
2004044;"Rajgród - miasto (4)";67;28;39;10;20;16;40;
2004045;"Rajgród - obszar wiejski (5)";159;80;79;33;57;43;85;
2004053;"Szczuczyn (3)";300;127;173;34;85;65;159;
2004054;"Szczuczyn - miasto (4)";210;88;122;17;52;55;112;
2004055;"Szczuczyn - obszar wiejski (5)";90;39;51;17;33;10;47;
2004062;"Wąsosz (2)";151;63;88;28;57;30;68;
2005000;"Powiat hajnowski";1223;500;723;114;247;385;673;
2005011;"Hajnówka (1)";567;234;333;56;125;146;261;
2005022;"Białowieża (2)";90;23;67;11;17;23;51;
2005032;"Czeremcha (2)";116;60;56;9;29;33;76;
2005042;"Czyże (2)";31;13;18;5;9;8;21;
2005052;"Dubicze Cerkiewne (2)";38;16;22;4;9;15;24;
2005062;"Hajnówka (2)";101;36;65;15;24;42;57;
2005073;"Kleszczele (3)";68;33;35;2;8;27;41;
2005074;"Kleszczele - miasto (4)";32;19;13;1;4;13;22;
2005075;"Kleszczele - obszar wiejski (5)";36;14;22;1;4;14;19;
2005082;"Narew (2)";120;52;68;10;16;56;84;
2005092;"Narewka (2)";92;33;59;2;10;35;58;
2006000;"Powiat kolneński";2272;1033;1239;453;869;469;1493;
2006011;"Kolno (1)";647;294;353;97;192;165;398;
2006022;"Grabowo (2)";155;69;86;35;63;36;104;
2006032;"Kolno (2)";526;238;288;129;227;82;332;
2006042;"Mały Płock (2)";282;120;162;45;114;62;199;
2006053;"Stawiski (3)";286;143;143;59;99;60;191;
2006054;"Stawiski - miasto (4)";147;84;63;18;37;40;95;
2006055;"Stawiski - obszar wiejski (5)";139;59;80;41;62;20;96;
2006062;"Turośl (2)";376;169;207;88;174;64;269;
2007000;"Powiat łomżyński";1257;675;582;265;508;236;558;
2007013;"Jedwabne (3)";102;57;45;20;39;19;49;
2007014;"Jedwabne - miasto (4)";62;34;28;6;16;13;33;
2007015;"Jedwabne - obszar wiejski (5)";40;23;17;14;23;6;16;
2007022;"Łomża (2)";315;172;143;69;128;53;122;
2007032;"Miastkowo (2)";125;62;63;23;50;22;70;
2007043;"Nowogród (3)";116;58;58;27;46;28;52;
2007044;"Nowogród - miasto (4)";83;41;42;17;31;24;38;
2007045;"Nowogród - obszar wiejski (5)";33;17;16;10;15;4;14;
2007052;"Piątnica (2)";253;138;115;51;103;46;111;
2007062;"Przytuły (2)";29;14;15;3;12;6;12;
2007072;"Śniadowo (2)";97;53;44;18;36;18;36;
2007082;"Wizna (2)";81;47;34;24;35;14;35;
2007092;"Zbójna (2)";139;74;65;30;59;30;71;
2008000;"Powiat moniecki";1092;535;557;193;363;276;580;
2008013;"Goniądz (3)";128;61;67;20;42;26;68;
2008014;"Goniądz - miasto (4)";67;31;36;8;20;17;34;
2008015;"Goniądz - obszar wiejski (5)";61;30;31;12;22;9;34;
2008022;"Jasionówka (2)";75;32;43;10;21;20;45;
2008032;"Jaświły (2)";94;52;42;25;36;20;51;
2008043;"Knyszyn (3)";154;77;77;20;38;47;86;
2008044;"Knyszyn - miasto (4)";99;53;46;10;20;31;53;
2008045;"Knyszyn - obszar wiejski (5)";55;24;31;10;18;16;33;
2008052;"Krypno (2)";117;54;63;25;41;24;66;
2008063;"Mońki (3)";424;214;210;77;155;110;201;
2008064;"Mońki - miasto (4)";312;155;157;51;101;84;145;
2008065;"Mońki - obszar wiejski (5)";112;59;53;26;54;26;56;
2008072;"Trzcianne (2)";100;45;55;16;30;29;63;
2009000;"Powiat sejneński";1136;443;693;182;346;239;648;
2009011;"Sejny (1)";350;120;230;51;95;75;190;
2009022;"Giby (2)";195;91;104;33;54;47;113;
2009032;"Krasnopol (2)";196;82;114;37;71;32;117;
2009042;"Puńsk (2)";180;66;114;22;50;48;99;
2009052;"Sejny (2)";215;84;131;39;76;37;129;
2010000;"Powiat siemiatycki";1059;484;575;155;313;314;585;
2010011;"Siemiatycze (1)";395;177;218;50;112;99;171;
2010023;"Drohiczyn (3)";130;70;60;27;44;30;80;
2010024;"Drohiczyn - miasto (4)";52;23;29;8;11;11;33;
2010025;"Drohiczyn - obszar wiejski (5)";78;47;31;19;33;19;47;
2010032;"Dziadkowice (2)";61;26;35;12;24;18;34;
2010042;"Grodzisk (2)";67;27;40;16;26;17;44;
2010052;"Mielnik (2)";52;19;33;8;12;22;32;
2010062;"Milejczyce (2)";54;19;35;6;19;15;33;
2010072;"Nurzec-Stacja (2)";145;70;75;17;30;66;100;
2010082;"Perlejewo (2)";35;19;16;8;17;8;25;
2010092;"Siemiatycze (2)";120;57;63;11;29;39;66;
2011000;"Powiat sokólski";2973;1202;1771;380;780;831;1924;
2011013;"Dąbrowa Białostocka (3)";591;215;376;113;198;146;372;
2011014;"Dąbrowa Białostocka - miasto (4)";324;115;209;56;96;85;209;
2011015;"Dąbrowa Białostocka - obszar wiejski (5)";267;100;167;57;102;61;163;
2011022;"Janów (2)";109;41;68;16;31;34;64;
2011032;"Korycin (2)";67;28;39;8;24;15;42;
2011043;"Krynki (3)";226;110;116;11;32;68;168;
2011044;"Krynki - miasto (4)";186;92;94;8;23;56;138;
2011045;"Krynki - obszar wiejski (5)";40;18;22;3;9;12;30;
2011052;"Kuźnica (2)";214;101;113;20;47;61;150;
2011062;"Nowy Dwór (2)";133;47;86;16;41;21;104;
2011072;"Sidra (2)";126;51;75;19;32;33;79;
2011083;"Sokółka (3)";1088;455;633;113;253;335;650;
2011084;"Sokółka - miasto (4)";809;340;469;70;177;246;478;
2011085;"Sokółka - obszar wiejski (5)";279;115;164;43;76;89;172;
2011093;"Suchowola (3)";283;91;192;51;101;71;191;
2011094;"Suchowola - miasto (4)";122;33;89;11;33;38;81;
2011095;"Suchowola - obszar wiejski (5)";161;58;103;40;68;33;110;
2011102;"Szudziałowo (2)";136;63;73;13;21;47;104;
2012000;"Powiat suwalski";716;365;351;122;271;160;228;
2012012;"Bakałarzewo (2)";57;20;37;11;20;13;19;
2012022;"Filipów (2)";94;45;49;17;34;22;41;
2012032;"Jeleniewo (2)";46;23;23;5;19;10;13;
2012042;"Przerośl (2)";79;40;39;19;37;15;23;
2012052;"Raczki (2)";95;50;45;11;29;19;32;
2012062;"Rutka-Tartak (2)";34;16;18;6;17;7;6;
2012072;"Suwałki (2)";176;93;83;25;61;43;53;
2012082;"Szypliszki (2)";95;54;41;16;34;28;27;
2012092;"Wiżajny (2)";40;24;16;12;20;3;14;
2013000;"Powiat wysokomazowiecki";1625;689;936;298;599;367;918;
2013011;"Wysokie Mazowieckie (1)";271;107;164;34;76;73;130;
2013023;"Ciechanowiec (3)";293;113;180;46;103;78;179;
2013024;"Ciechanowiec - miasto (4)";200;72;128;30;66;58;120;
2013025;"Ciechanowiec - obszar wiejski (5)";93;41;52;16;37;20;59;
2013033;"Czyżew (3)";167;79;88;28;56;44;98;
2013034;"Czyżew - miasto (4)";73;34;39;14;27;21;39;
2013035;"Czyżew - obszar wiejski (5)";94;45;49;14;29;23;59;
2013042;"Klukowo (2)";139;61;78;38;61;19;90;
2013052;"Kobylin-Borzymy (2)";56;22;34;16;28;4;29;
2013062;"Kulesze Kościelne (2)";74;40;34;17;33;13;43;
2013072;"Nowe Piekuty (2)";80;31;49;18;38;17;46;
2013082;"Sokoły (2)";164;76;88;36;69;31;94;
2013093;"Szepietowo (3)";245;104;141;38;82;56;139;
2013094;"Szepietowo - miasto (4)";99;42;57;9;17;27;63;
2013095;"Szepietowo - obszar wiejski (5)";146;62;84;29;65;29;76;
2013102;"Wysokie Mazowieckie (2)";136;56;80;27;53;32;70;
2014000;"Powiat zambrowski";1196;607;589;209;395;323;553;
2014011;"Zambrów (1)";787;402;385;135;249;224;369;
2014022;"Kołaki Kościelne (2)";22;11;11;2;10;5;11;
2014032;"Rutki (2)";132;57;75;19;40;40;69;
2014042;"Szumowo (2)";69;36;33;14;28;15;25;
2014052;"Zambrów (2)";186;101;85;39;68;39;79;
2061000;"Powiat m.Białystok";8454;4018;4436;684;1869;2319;4180;
2061011;"Białystok (1)";8454;4018;4436;684;1869;2319;4180;
2062000;"Powiat m.Łomża";2016;1091;925;208;506;567;917;
2062011;"Łomża (1)";2016;1091;925;208;506;567;917;
2063000;"Powiat m.Suwałki";2026;1041;985;240;556;531;661;
2063011;"Suwałki (1)";2026;1041;985;240;556;531;661;
2200000;"POMORSKIE";52341;31134;21207;7374;15371;11932;19990;
2201000;"Powiat bytowski";3142;1888;1254;554;1050;706;1393;
2201012;"Borzytuchom (2)";125;79;46;27;50;21;40;
2201023;"Bytów (3)";715;463;252;143;241;147;267;
2201024;"Bytów - miasto (4)";477;315;162;90;152;97;183;
2201025;"Bytów - obszar wiejski (5)";238;148;90;53;89;50;84;
2201032;"Czarna Dąbrówka (2)";280;182;98;57;88;71;129;
2201042;"Kołczygłowy (2)";159;94;65;29;55;33;56;
2201052;"Lipnica (2)";117;73;44;32;57;21;53;
2201063;"Miastko (3)";1230;672;558;179;381;292;621;
2201064;"Miastko - miasto (4)";540;278;262;72;134;145;252;
2201065;"Miastko - obszar wiejski (5)";690;394;296;107;247;147;369;
2201072;"Parchowo (2)";97;65;32;16;40;19;45;
2201082;"Studzienice (2)";107;67;40;26;50;18;35;
2201092;"Trzebielino (2)";184;119;65;19;44;49;98;
2201102;"Tuchomie (2)";128;74;54;26;44;35;49;
2202000;"Powiat chojnicki";3301;2100;1201;563;1137;697;1680;
2202011;"Chojnice (1)";1015;630;385;137;298;237;419;
2202023;"Brusy (3)";551;376;175;105;226;101;340;
2202024;"Brusy - miasto (4)";169;109;60;26;65;35;97;
2202025;"Brusy - obszar wiejski (5)";382;267;115;79;161;66;243;
2202032;"Chojnice (2)";690;430;260;136;260;139;344;
2202043;"Czersk (3)";945;599;346;158;310;196;518;
2202044;"Czersk - miasto (4)";324;198;126;38;84;77;171;
2202045;"Czersk - obszar wiejski (5)";621;401;220;120;226;119;347;
2202052;"Konarzyny (2)";100;65;35;27;43;24;59;
2203000;"Powiat człuchowski";2130;1218;912;314;605;566;865;
2203011;"Człuchów (1)";425;226;199;46;105;126;174;
2203023;"Czarne (3)";345;180;165;61;98;97;147;
2203024;"Czarne - miasto (4)";204;94;110;40;60;58;75;
2203025;"Czarne - obszar wiejski (5)";141;86;55;21;38;39;72;
2203032;"Człuchów (2)";457;282;175;80;148;92;169;
2203043;"Debrzno (3)";389;228;161;63;110;102;177;
2203044;"Debrzno - miasto (4)";180;101;79;30;53;36;62;
2203045;"Debrzno - obszar wiejski (5)";209;127;82;33;57;66;115;
2203052;"Koczała (2)";141;83;58;15;34;47;68;
2203062;"Przechlewo (2)";229;131;98;28;64;61;77;
2203072;"Rzeczenica (2)";144;88;56;21;46;41;53;
2204000;"Powiat gdański";2069;1382;687;280;616;417;859;
2204011;"Pruszcz Gdański (1)";506;333;173;50;113;111;216;
2204022;"Cedry Wielkie (2)";158;115;43;24;54;39;77;
2204032;"Kolbudy (2)";270;175;95;37;82;70;105;
2204042;"Pruszcz Gdański (2)";542;348;194;68;162;93;204;
2204052;"Przywidz (2)";109;69;40;24;41;23;51;
2204062;"Pszczółki (2)";176;125;51;22;49;31;61;
2204072;"Suchy Dąb (2)";95;69;26;16;30;14;46;
2204082;"Trąbki Wielkie (2)";213;148;65;39;85;36;99;
2205000;"Powiat kartuski";1879;1193;686;432;737;345;347;
2205012;"Chmielno (2)";112;74;38;25;47;21;21;
2205023;"Kartuzy (3)";532;322;210;123;197;109;101;
2205024;"Kartuzy - miasto (4)";226;134;92;41;68;49;39;
2205025;"Kartuzy - obszar wiejski (5)";306;188;118;82;129;60;62;
2205032;"Przodkowo (2)";111;64;47;28;45;18;13;
2205042;"Sierakowice (2)";256;174;82;86;140;33;51;
2205052;"Somonino (2)";183;110;73;42;71;27;28;
2205062;"Stężyca (2)";131;80;51;24;44;36;28;
2205072;"Sulęczyno (2)";84;61;23;27;47;11;23;
2205083;"Żukowo (3)";470;308;162;77;146;90;82;
2205084;"Żukowo - miasto (4)";36;18;18;6;10;9;3;
2205085;"Żukowo - obszar wiejski (5)";434;290;144;71;136;81;79;
2206000;"Powiat kościerski";1990;1140;850;395;722;371;833;
2206011;"Kościerzyna (1)";713;377;336;125;215;151;316;
2206022;"Dziemiany (2)";103;61;42;20;40;15;42;
2206032;"Karsin (2)";151;90;61;37;69;21;65;
2206042;"Kościerzyna (2)";412;256;156;86;153;72;145;
2206052;"Liniewo (2)";154;92;62;23;48;33;67;
2206062;"Lipusz (2)";101;52;49;24;42;17;45;
2206072;"Nowa Karczma (2)";196;118;78;49;89;32;89;
2206082;"Stara Kiszewa (2)";160;94;66;31;66;30;64;
2207000;"Powiat kwidzyński";2292;1464;828;329;686;540;936;
2207011;"Kwidzyn (1)";870;529;341;100;212;220;327;
2207022;"Gardeja (2)";274;191;83;46;95;59;124;
2207032;"Kwidzyn (2)";337;220;117;46;109;86;147;
2207043;"Prabuty (3)";460;291;169;74;144;99;183;
2207044;"Prabuty - miasto (4)";291;184;107;54;93;64;108;
2207045;"Prabuty - obszar wiejski (5)";169;107;62;20;51;35;75;
2207052;"Ryjewo (2)";190;119;71;29;55;49;90;
2207062;"Sadlinki (2)";161;114;47;34;71;27;65;
2208000;"Powiat lęborski";2180;1283;897;310;648;522;981;
2208011;"Lębork (1)";1147;672;475;155;330;258;501;
2208021;"Łeba (1)";141;68;73;13;32;57;78;
2208032;"Cewice (2)";216;136;80;40;85;30;101;
2208042;"Nowa Wieś Lęborska (2)";423;261;162;71;133;106;168;
2208052;"Wicko (2)";253;146;107;31;68;71;133;
2209000;"Powiat malborski";1986;1274;712;291;602;466;855;
2209011;"Malbork (1)";1126;698;428;156;330;262;464;
2209032;"Lichnowy (2)";154;103;51;24;52;43;79;
2209042;"Malbork (2)";149;91;58;29;44;34;61;
2209062;"Miłoradz (2)";95;64;31;12;34;22;38;
2209073;"Nowy Staw (3)";289;203;86;43;86;58;134;
2209074;"Nowy Staw - miasto (4)";128;87;41;17;36;23;59;
2209075;"Nowy Staw - obszar wiejski (5)";161;116;45;26;50;35;75;
2209082;"Stare Pole (2)";173;115;58;27;56;47;79;
2210000;"Powiat nowodworski";1456;805;651;216;431;365;649;
2210011;"Krynica Morska (1)";37;21;16;5;11;9;16;
2210023;"Nowy Dwór Gdański (3)";820;461;359;126;255;178;368;
2210024;"Nowy Dwór Gdański - miasto (4)";426;232;194;69;134;85;181;
2210025;"Nowy Dwór Gdański - obszar wiejski (5)";394;229;165;57;121;93;187;
2210032;"Ostaszewo (2)";123;77;46;18;33;33;57;
2210042;"Stegna (2)";327;171;156;40;84;105;146;
2210052;"Sztutowo (2)";149;75;74;27;48;40;62;
2211000;"Powiat pucki";1940;1101;839;320;585;462;723;
2211011;"Hel (1)";69;35;34;10;23;13;29;
2211023;"Jastarnia (3)";109;44;65;11;18;46;52;
2211024;"Jastarnia - miasto (4)";81;28;53;9;14;35;40;
2211025;"Jastarnia - obszar wiejski (5)";28;16;12;2;4;11;12;
2211031;"Puck (1)";290;155;135;35;73;77;111;
2211043;"Władysławowo (3)";359;192;167;45;89;97;149;
2211044;"Władysławowo - miasto (4)";239;132;107;32;64;65;107;
2211045;"Władysławowo - obszar wiejski (5)";120;60;60;13;25;32;42;
2211052;"Kosakowo (2)";257;178;79;30;64;48;100;
2211062;"Krokowa (2)";253;148;105;50;103;52;90;
2211072;"Puck (2)";603;349;254;139;215;129;192;
2212000;"Powiat słupski";2774;1522;1252;367;785;698;970;
2212011;"Ustka (1)";273;124;149;27;62;83;77;
2212022;"Damnica (2)";153;87;66;25;59;28;41;
2212032;"Dębnica Kaszubska (2)";485;281;204;54;117;136;240;
2212042;"Główczyce (2)";209;110;99;26;62;49;61;
2212053;"Kępice (3)";467;259;208;61;113;133;231;
2212054;"Kępice - miasto (4)";167;80;87;23;36;44;77;
2212055;"Kępice - obszar wiejski (5)";300;179;121;38;77;89;154;
2212062;"Kobylnica (2)";306;184;122;46;93;61;68;
2212072;"Potęgowo (2)";227;136;91;36;83;54;91;
2212082;"Słupsk (2)";421;210;211;59;118;97;101;
2212092;"Smołdzino (2)";81;43;38;10;25;21;21;
2212102;"Ustka (2)";152;88;64;23;53;36;39;
2213000;"Powiat starogardzki";3031;1882;1149;523;980;709;1066;
2213013;"Czarna Woda (3)";84;52;32;9;25;19;36;
2213014;"Czarna Woda - miasto (4)";68;42;26;8;22;15;30;
2213015;"Czarna Woda - obszar wiejski (5)";16;10;6;1;3;4;6;
2213021;"Skórcz (1)";95;56;39;25;34;24;27;
2213031;"Starogard Gdański (1)";1057;631;426;156;293;274;309;
2213042;"Bobowo (2)";80;46;34;10;21;24;26;
2213052;"Kaliska (2)";129;84;45;23;42;33;35;
2213062;"Lubichowo (2)";205;138;67;31;80;36;97;
2213072;"Osieczna (2)";123;71;52;15;33;38;65;
2213082;"Osiek (2)";82;43;39;14;25;22;37;
2213093;"Skarszewy (3)";326;207;119;76;131;63;118;
2213094;"Skarszewy - miasto (4)";150;98;52;32;55;32;40;
2213095;"Skarszewy - obszar wiejski (5)";176;109;67;44;76;31;78;
2213102;"Skórcz (2)";119;78;41;21;40;19;49;
2213112;"Smętowo Graniczne (2)";149;107;42;32;57;27;73;
2213122;"Starogard Gdański (2)";323;204;119;61;110;77;111;
2213132;"Zblewo (2)";259;165;94;50;89;53;83;
2214000;"Powiat tczewski";2925;1794;1131;480;916;611;1257;
2214011;"Tczew (1)";1486;877;609;205;411;317;617;
2214023;"Gniew (3)";425;268;157;94;164;79;185;
2214024;"Gniew - miasto (4)";180;112;68;32;55;34;78;
2214025;"Gniew - obszar wiejski (5)";245;156;89;62;109;45;107;
2214032;"Morzeszczyn (2)";114;80;34;23;46;16;57;
2214043;"Pelplin (3)";388;268;120;64;129;77;165;
2214044;"Pelplin - miasto (4)";177;125;52;29;60;39;66;
2214045;"Pelplin - obszar wiejski (5)";211;143;68;35;69;38;99;
2214052;"Subkowy (2)";146;84;62;28;49;43;77;
2214062;"Tczew (2)";366;217;149;66;117;79;156;
2215000;"Powiat wejherowski";4348;2746;1602;698;1395;838;1450;
2215011;"Reda (1)";500;332;168;52;120;98;156;
2215021;"Rumia (1)";822;504;318;90;224;186;258;
2215031;"Wejherowo (1)";1107;686;421;140;303;220;371;
2215042;"Choczewo (2)";170;108;62;31;52;40;79;
2215052;"Gniewino (2)";167;99;68;37;62;33;56;
2215062;"Linia (2)";105;78;27;25;52;8;34;
2215072;"Luzino (2)";353;243;110;90;155;44;114;
2215082;"Łęczyce (2)";252;156;96;49;89;51;93;
2215092;"Szemud (2)";250;146;104;57;115;41;83;
2215102;"Wejherowo (2)";622;394;228;127;223;117;206;
2216000;"Powiat sztumski";1123;793;330;202;364;226;431;
2216013;"Dzierzgoń (3)";366;275;91;55;120;77;176;
2216014;"Dzierzgoń - miasto (4)";182;129;53;22;55;41;76;
2216015;"Dzierzgoń - obszar wiejski (5)";184;146;38;33;65;36;100;
2216022;"Mikołajki Pomorskie (2)";82;61;21;22;33;12;27;
2216032;"Stary Dzierzgoń (2)";167;124;43;32;65;31;81;
2216042;"Stary Targ (2)";176;116;60;28;48;41;58;
2216053;"Sztum (3)";332;217;115;65;98;65;89;
2216054;"Sztum - miasto (4)";164;106;58;30;48;31;41;
2216055;"Sztum - obszar wiejski (5)";168;111;57;35;50;34;48;
2261000;"Powiat m.Gdańsk";7901;4364;3537;602;1758;1968;3169;
2261011;"Gdańsk (1)";7901;4364;3537;602;1758;1968;3169;
2262000;"Powiat m.Gdynia";3503;1995;1508;277;788;798;977;
2262011;"Gdynia (1)";3503;1995;1508;277;788;798;977;
2263000;"Powiat m.Słupsk";1926;976;950;195;482;507;429;
2263011;"Słupsk (1)";1926;976;950;195;482;507;429;
2264000;"Powiat m.Sopot";445;214;231;26;84;120;120;
2264011;"Sopot (1)";445;214;231;26;84;120;120;
2400000;"ŚLĄSKIE";86784;47543;39241;10165;21819;22554;31961;
2401000;"Powiat będziński";3283;1644;1639;278;643;964;1216;
2401011;"Będzin (1)";1445;742;703;107;281;440;557;
2401021;"Czeladź (1)";686;326;360;46;124;215;266;
2401031;"Wojkowice (1)";165;85;80;17;32;46;47;
2401042;"Bobrowniki (2)";214;103;111;27;41;66;79;
2401052;"Mierzęcice (2)";129;69;60;15;27;44;45;
2401062;"Psary (2)";230;116;114;23;52;54;83;
2401073;"Siewierz (3)";274;134;140;30;64;64;106;
2401074;"Siewierz - miasto (4)";143;69;74;18;32;34;56;
2401075;"Siewierz - obszar wiejski (5)";131;65;66;12;32;30;50;
2401081;"Sławków (1)";140;69;71;13;22;35;33;
2402000;"Powiat bielski";2599;1413;1186;350;708;643;753;
2402011;"Szczyrk (1)";113;56;57;17;22;29;36;
2402022;"Bestwina (2)";197;112;85;34;63;44;61;
2402032;"Buczkowice (2)";213;126;87;27;60;54;62;
2402043;"Czechowice-Dziedzice (3)";907;474;433;118;239;217;292;
2402044;"Czechowice-Dziedzice - miasto (4)";751;397;354;98;192;179;240;
2402045;"Czechowice-Dziedzice - obszar wiejski (5)";156;77;79;20;47;38;52;
2402052;"Jasienica (2)";268;140;128;27;65;66;67;
2402062;"Jaworze (2)";113;57;56;13;33;32;36;
2402072;"Kozy (2)";169;98;71;25;46;42;33;
2402082;"Porąbka (2)";226;126;100;27;65;68;60;
2402093;"Wilamowice (3)";221;126;95;43;76;41;44;
2402094;"Wilamowice - miasto (4)";49;26;23;14;23;2;10;
2402095;"Wilamowice - obszar wiejski (5)";172;100;72;29;53;39;34;
2402102;"Wilkowice (2)";172;98;74;19;39;50;62;
2403000;"Powiat cieszyński";3861;2052;1809;542;1075;1026;1573;
2403011;"Cieszyn (1)";743;364;379;80;167;221;295;
2403021;"Ustroń (1)";379;190;189;39;77;120;166;
2403031;"Wisła (1)";311;141;170;30;83;98;130;
2403042;"Brenna (2)";257;148;109;32;67;70;103;
2403052;"Chybie (2)";193;119;74;28;52;53;80;
2403062;"Dębowiec (2)";97;54;43;14;35;22;37;
2403072;"Goleszów (2)";301;165;136;50;90;77;130;
2403082;"Hażlach (2)";234;125;109;45;86;39;93;
2403092;"Istebna (2)";317;172;145;52;97;87;142;
2403103;"Skoczów (3)";562;314;248;94;183;126;214;
2403104;"Skoczów - miasto (4)";328;192;136;44;86;88;127;
2403105;"Skoczów - obszar wiejski (5)";234;122;112;50;97;38;87;
2403113;"Strumień (3)";248;143;105;45;72;64;91;
2403114;"Strumień - miasto (4)";88;51;37;18;29;25;33;
2403115;"Strumień - obszar wiejski (5)";160;92;68;27;43;39;58;
2403122;"Zebrzydowice (2)";219;117;102;33;66;49;92;
2404000;"Powiat częstochowski";3359;1730;1629;413;899;921;1250;
2404013;"Blachownia (3)";261;131;130;23;54;78;67;
2404014;"Blachownia - miasto (4)";188;91;97;16;39;54;51;
2404015;"Blachownia - obszar wiejski (5)";73;40;33;7;15;24;16;
2404022;"Dąbrowa Zielona (2)";219;105;114;30;58;72;130;
2404032;"Janów (2)";160;78;82;19;37;54;54;
2404042;"Kamienica Polska (2)";104;60;44;11;18;32;29;
2404052;"Kłomnice (2)";231;132;99;40;80;50;63;
2404063;"Koniecpol (3)";555;292;263;77;155;137;314;
2404064;"Koniecpol - miasto (4)";316;170;146;32;73;87;183;
2404065;"Koniecpol - obszar wiejski (5)";239;122;117;45;82;50;131;
2404072;"Konopiska (2)";183;92;91;24;56;54;53;
2404082;"Kruszyna (2)";96;48;48;9;20;30;27;
2404092;"Lelów (2)";225;114;111;24;69;58;138;
2404102;"Mstów (2)";211;113;98;31;66;45;51;
2404112;"Mykanów (2)";264;131;133;33;68;86;71;
2404122;"Olsztyn (2)";180;94;86;26;51;43;45;
2404132;"Poczesna (2)";234;130;104;13;47;69;63;
2404142;"Przyrów (2)";157;76;81;18;42;41;85;
2404152;"Rędziny (2)";221;105;116;25;63;61;43;
2404162;"Starcza (2)";58;29;29;10;15;11;17;
2405000;"Powiat gliwicki";1696;944;752;206;450;456;684;
2405011;"Knurów (1)";511;292;219;66;147;101;154;
2405021;"Pyskowice (1)";319;177;142;34;69;104;130;
2405032;"Gierałtowice (2)";124;66;58;19;42;23;34;
2405042;"Pilchowice (2)";160;82;78;14;43;50;71;
2405052;"Rudziniec (2)";213;115;98;16;41;80;108;
2405063;"Sośnicowice (3)";117;66;51;17;32;30;60;
2405064;"Sośnicowice - miasto (4)";22;12;10;4;6;6;10;
2405065;"Sośnicowice - obszar wiejski (5)";95;54;41;13;26;24;50;
2405073;"Toszek (3)";147;91;56;20;38;39;67;
2405074;"Toszek - miasto (4)";66;36;30;11;20;13;24;
2405075;"Toszek - obszar wiejski (5)";81;55;26;9;18;26;43;
2405082;"Wielowieś (2)";105;55;50;20;38;29;60;
2406000;"Powiat kłobucki";2546;1271;1275;350;750;638;1064;
2406013;"Kłobuck (3)";685;343;342;70;171;172;248;
2406014;"Kłobuck - miasto (4)";451;233;218;39;103;114;161;
2406015;"Kłobuck - obszar wiejski (5)";234;110;124;31;68;58;87;
2406023;"Krzepice (3)";240;121;119;35;72;61;92;
2406024;"Krzepice - miasto (4)";124;57;67;18;36;33;43;
2406025;"Krzepice - obszar wiejski (5)";116;64;52;17;36;28;49;
2406032;"Lipie (2)";160;93;67;28;62;39;75;
2406042;"Miedźno (2)";239;126;113;35;80;55;105;
2406052;"Opatów (2)";182;97;85;33;65;45;73;
2406062;"Panki (2)";138;60;78;16;37;32;56;
2406072;"Popów (2)";132;68;64;20;46;27;53;
2406082;"Przystajń (2)";164;78;86;24;49;42;77;
2406092;"Wręczyca Wielka (2)";606;285;321;89;168;165;285;
2407000;"Powiat lubliniecki";1684;1011;673;239;495;417;843;
2407011;"Lubliniec (1)";490;281;209;43;117;121;240;
2407022;"Boronów (2)";78;48;30;9;25;16;45;
2407032;"Ciasna (2)";153;89;64;22;47;39;89;
2407042;"Herby (2)";188;116;72;30;56;45;102;
2407052;"Kochanowice (2)";161;94;67;24;50;46;78;
2407062;"Koszęcin (2)";244;151;93;38;79;69;119;
2407072;"Pawonków (2)";133;83;50;34;49;24;57;
2407083;"Woźniki (3)";237;149;88;39;72;57;113;
2407084;"Woźniki - miasto (4)";108;63;45;16;33;27;46;
2407085;"Woźniki - obszar wiejski (5)";129;86;43;23;39;30;67;
2408000;"Powiat mikołowski";1591;912;679;227;450;383;453;
2408011;"Łaziska Górne (1)";392;228;164;53;104;93;114;
2408021;"Mikołów (1)";649;361;288;85;172;165;178;
2408031;"Orzesze (1)";354;206;148;56;105;79;109;
2408042;"Ornontowice (2)";81;53;28;15;32;16;27;
2408052;"Wyry (2)";115;64;51;18;37;30;25;
2409000;"Powiat myszkowski";1776;937;839;225;468;461;622;
2409011;"Myszków (1)";806;438;368;93;202;208;258;
2409023;"Koziegłowy (3)";321;155;166;53;97;79;128;
2409024;"Koziegłowy - miasto (4)";55;25;30;12;18;8;14;
2409025;"Koziegłowy - obszar wiejski (5)";266;130;136;41;79;71;114;
2409032;"Niegowa (2)";153;82;71;23;52;32;65;
2409042;"Poraj (2)";230;123;107;26;47;71;66;
2409053;"Żarki (3)";266;139;127;30;70;71;105;
2409054;"Żarki - miasto (4)";135;79;56;14;36;40;47;
2409055;"Żarki - obszar wiejski (5)";131;60;71;16;34;31;58;
2410000;"Powiat pszczyński";1620;984;636;249;487;389;533;
2410012;"Goczałkowice-Zdrój (2)";81;37;44;16;26;20;36;
2410022;"Kobiór (2)";69;30;39;14;21;16;19;
2410032;"Miedźna (2)";214;129;85;40;74;48;53;
2410042;"Pawłowice (2)";187;119;68;35;70;38;51;
2410053;"Pszczyna (3)";937;571;366;124;253;239;337;
2410054;"Pszczyna - miasto (4)";508;291;217;49;114;143;183;
2410055;"Pszczyna - obszar wiejski (5)";429;280;149;75;139;96;154;
2410062;"Suszec (2)";132;98;34;20;43;28;37;
2411000;"Powiat raciborski";1873;1139;734;222;518;496;863;
2411011;"Racibórz (1)";1046;621;425;101;265;285;471;
2411022;"Kornowac (2)";71;39;32;12;24;11;26;
2411033;"Krzanowice (3)";106;73;33;21;38;22;44;
2411034;"Krzanowice - miasto (4)";48;33;15;10;18;8;17;
2411035;"Krzanowice - obszar wiejski (5)";58;40;18;11;20;14;27;
2411042;"Krzyżanowice (2)";184;106;78;22;48;55;90;
2411053;"Kuźnia Raciborska (3)";201;133;68;27;59;52;112;
2411054;"Kuźnia Raciborska - miasto (4)";118;80;38;15;33;31;67;
2411055;"Kuźnia Raciborska - obszar wiejski (5)";83;53;30;12;26;21;45;
2411062;"Nędza (2)";106;66;40;14;33;32;46;
2411072;"Pietrowice Wielkie (2)";73;48;25;12;26;16;32;
2411082;"Rudnik (2)";86;53;33;13;25;23;42;
2412000;"Powiat rybnicki";1112;706;406;174;335;260;423;
2412013;"Czerwionka-Leszczyny (3)";679;434;245;83;188;169;289;
2412014;"Czerwionka-Leszczyny - miasto (4)";495;324;171;56;136;119;213;
2412015;"Czerwionka-Leszczyny - obszar wiejski (5)";184;110;74;27;52;50;76;
2412022;"Gaszowice (2)";118;65;53;16;29;31;45;
2412032;"Jejkowice (2)";48;31;17;13;17;9;16;
2412042;"Lyski (2)";114;70;44;25;42;20;36;
2412052;"Świerklany (2)";153;106;47;37;59;31;37;
2413000;"Powiat tarnogórski";2989;1652;1337;367;771;706;1325;
2413011;"Kalety (1)";251;159;92;31;69;54;134;
2413021;"Miasteczko Śląskie (1)";179;111;68;25;49;42;76;
2413031;"Radzionków (1)";338;181;157;48;91;88;147;
2413041;"Tarnowskie Góry (1)";1385;743;642;138;309;344;608;
2413052;"Krupski Młyn (2)";51;28;23;12;20;9;16;
2413062;"Ożarowice (2)";119;68;51;18;39;21;45;
2413072;"Świerklaniec (2)";252;143;109;26;60;53;104;
2413082;"Tworóg (2)";151;75;76;29;51;38;69;
2413092;"Zbrosławice (2)";263;144;119;40;83;57;126;
2414000;"Powiat bieruńsko-lędziński";678;368;310;104;190;161;160;
2414011;"Bieruń (1)";221;112;109;32;58;55;55;
2414021;"Imielin (1)";105;66;39;16;26;23;24;
2414031;"Lędziny (1)";232;120;112;36;66;57;54;
2414042;"Bojszowy (2)";63;33;30;11;20;13;12;
2414052;"Chełm Śląski (2)";57;37;20;9;20;13;15;
2415000;"Powiat wodzisławski";3061;1799;1262;559;985;669;1114;
2415011;"Pszów (1)";275;146;129;48;85;66;104;
2415021;"Radlin (1)";377;229;148;78;132;89;142;
2415031;"Rydułtowy (1)";472;281;191;89;144;97;209;
2415041;"Wodzisław Śląski (1)";1049;596;453;154;310;255;371;
2415052;"Godów (2)";215;129;86;41;77;40;66;
2415062;"Gorzyce (2)";360;218;142;74;129;63;115;
2415072;"Lubomia (2)";128;79;49;27;39;27;52;
2415082;"Marklowice (2)";77;49;28;19;28;15;22;
2415092;"Mszana (2)";108;72;36;29;41;17;33;
2416000;"Powiat zawierciański";2838;1548;1290;290;669;762;1247;
2416011;"Poręba (1)";208;117;91;26;55;60;84;
2416021;"Zawiercie (1)";1246;712;534;105;262;332;548;
2416032;"Irządze (2)";48;28;20;13;23;3;17;
2416042;"Kroczyce (2)";135;59;76;16;38;42;68;
2416053;"Łazy (3)";401;203;198;26;79;116;196;
2416054;"Łazy - miasto (4)";195;103;92;7;38;52;94;
2416055;"Łazy - obszar wiejski (5)";206;100;106;19;41;64;102;
2416063;"Ogrodzieniec (3)";221;117;104;20;56;52;87;
2416064;"Ogrodzieniec - miasto (4)";99;44;55;8;22;23;38;
2416065;"Ogrodzieniec - obszar wiejski (5)";122;73;49;12;34;29;49;
2416073;"Pilica (3)";157;92;65;32;52;37;54;
2416074;"Pilica - miasto (4)";36;22;14;5;9;6;14;
2416075;"Pilica - obszar wiejski (5)";121;70;51;27;43;31;40;
2416083;"Szczekociny (3)";203;99;104;21;48;59;94;
2416084;"Szczekociny - miasto (4)";111;54;57;11;24;39;45;
2416085;"Szczekociny - obszar wiejski (5)";92;45;47;10;24;20;49;
2416092;"Włodowice (2)";157;82;75;13;29;50;75;
2416102;"Żarnowiec (2)";62;39;23;18;27;11;24;
2417000;"Powiat żywiecki";4135;2172;1963;555;1132;1169;1678;
2417011;"Żywiec (1)";726;365;361;62;153;233;282;
2417022;"Czernichów (2)";152;89;63;20;45;49;72;
2417032;"Gilowice (2)";150;90;60;27;55;30;48;
2417042;"Jeleśnia (2)";415;198;217;47;103;124;180;
2417052;"Koszarawa (2)";72;37;35;7;17;24;30;
2417062;"Lipowa (2)";270;136;134;36;69;71;97;
2417072;"Łękawica (2)";143;84;59;25;45;36;57;
2417082;"Łodygowice (2)";331;182;149;38;84;95;122;
2417092;"Milówka (2)";253;124;129;37;85;62;77;
2417102;"Radziechowy-Wieprz (2)";376;211;165;67;127;95;130;
2417112;"Rajcza (2)";273;140;133;43;77;67;144;
2417122;"Ślemień (2)";93;54;39;11;28;28;44;
2417132;"Świnna (2)";196;101;95;32;64;51;72;
2417142;"Ujsoły (2)";166;87;79;31;50;41;73;
2417152;"Węgierska Górka (2)";519;274;245;72;130;163;250;
2461000;"Powiat m.Bielsko-Biała";2605;1392;1213;263;613;702;810;
2461011;"Bielsko-Biała (1)";2605;1392;1213;263;613;702;810;
2462000;"Powiat m.Bytom";4945;2778;2167;544;1215;1301;2196;
2462011;"Bytom (1)";4945;2778;2167;544;1215;1301;2196;
2463000;"Powiat m.Chorzów";1834;1026;808;165;399;479;637;
2463011;"Chorzów (1)";1834;1026;808;165;399;479;637;
2464000;"Powiat m.Częstochowa";4432;2351;2081;368;893;1359;1248;
2464011;"Częstochowa (1)";4432;2351;2081;368;893;1359;1248;
2465000;"Powiat m.Dąbrowa Górnicza";2904;1545;1359;263;598;762;1170;
2465011;"Dąbrowa Górnicza (1)";2904;1545;1359;263;598;762;1170;
2466000;"Powiat m.Gliwice";2971;1545;1426;248;649;832;1124;
2466011;"Gliwice (1)";2971;1545;1426;248;649;832;1124;
2467000;"Powiat m.Jastrzębie-Zdrój";1839;1104;735;300;587;371;581;
2467011;"Jastrzębie-Zdrój (1)";1839;1104;735;300;587;371;581;
2468000;"Powiat m.Jaworzno";1484;833;651;175;377;363;510;
2468011;"Jaworzno (1)";1484;833;651;175;377;363;510;
2469000;"Powiat m.Katowice";3241;1679;1562;269;700;881;934;
2469011;"Katowice (1)";3241;1679;1562;269;700;881;934;
2470000;"Powiat m.Mysłowice";1662;956;706;172;368;425;660;
2470011;"Mysłowice (1)";1662;956;706;172;368;425;660;
2471000;"Powiat m.Piekary Śląskie";1278;678;600;145;308;292;563;
2471011;"Piekary Śląskie (1)";1278;678;600;145;308;292;563;
2472000;"Powiat m.Ruda Śląska";1366;802;564;211;431;309;271;
2472011;"Ruda Śląska (1)";1366;802;564;211;431;309;271;
2473000;"Powiat m.Rybnik";2197;1343;854;315;592;510;771;
2473011;"Rybnik (1)";2197;1343;854;315;592;510;771;
2474000;"Powiat m.Siemianowice Śląskie";1417;797;620;177;341;348;411;
2474011;"Siemianowice Śląskie (1)";1417;797;620;177;341;348;411;
2475000;"Powiat m.Sosnowiec";4683;2355;2328;366;903;1310;1931;
2475011;"Sosnowiec (1)";4683;2355;2328;366;903;1310;1931;
2476000;"Powiat m.Świętochłowice";881;520;361;106;226;206;323;
2476011;"Świętochłowice (1)";881;520;361;106;226;206;323;
2477000;"Powiat m.Tychy";1818;964;854;168;406;461;489;
2477011;"Tychy (1)";1818;964;854;168;406;461;489;
2478000;"Powiat m.Zabrze";3468;1962;1506;384;867;948;1258;
2478011;"Zabrze (1)";3468;1962;1506;384;867;948;1258;
2479000;"Powiat m.Żory";1058;631;427;176;321;174;273;
2479011;"Żory (1)";1058;631;427;176;321;174;273;
2600000;"ŚWIĘTOKRZYSKIE";45778;23263;22515;6120;12926;11155;22714;
2601000;"Powiat buski";1430;715;715;257;519;303;590;
2601013;"Busko-Zdrój (3)";760;364;396;112;241;173;299;
2601014;"Busko-Zdrój - miasto (4)";359;155;204;32;96;97;140;
2601015;"Busko-Zdrój - obszar wiejski (5)";401;209;192;80;145;76;159;
2601022;"Gnojno (2)";77;33;44;22;43;11;33;
2601033;"Nowy Korczyn (3)";103;56;47;18;37;25;51;
2601034;"Nowy Korczyn - miasto (4)";28;17;11;2;8;10;19;
2601035;"Nowy Korczyn - obszar wiejski (5)";75;39;36;16;29;15;32;
2601043;"Pacanów (3)";112;57;55;24;45;23;55;
2601044;"Pacanów - miasto (4)";25;9;16;3;7;8;13;
2601045;"Pacanów - obszar wiejski (5)";87;48;39;21;38;15;42;
2601052;"Solec-Zdrój (2)";85;35;50;22;34;19;34;
2601063;"Stopnica (3)";131;79;52;22;47;30;56;
2601064;"Stopnica - miasto (4)";24;13;11;4;10;8;14;
2601065;"Stopnica - obszar wiejski (5)";107;66;41;18;37;22;42;
2601072;"Tuczępy (2)";72;36;36;14;32;12;27;
2601083;"Wiślica (3)";90;55;35;23;40;10;35;
2601084;"Wiślica - miasto (4)";11;5;6;2;5;0;3;
2601085;"Wiślica - obszar wiejski (5)";79;50;29;21;35;10;32;
2602000;"Powiat jędrzejowski";2594;1544;1050;418;846;574;1446;
2602012;"Imielno (2)";137;82;55;34;59;28;72;
2602023;"Jędrzejów (3)";933;527;406;114;254;249;521;
2602024;"Jędrzejów - miasto (4)";561;302;259;51;121;159;312;
2602025;"Jędrzejów - obszar wiejski (5)";372;225;147;63;133;90;209;
2602033;"Małogoszcz (3)";362;247;115;46;96;76;203;
2602034;"Małogoszcz - miasto (4)";124;91;33;15;26;26;68;
2602035;"Małogoszcz - obszar wiejski (5)";238;156;82;31;70;50;135;
2602042;"Nagłowice (2)";152;80;72;35;67;27;85;
2602052;"Oksa (2)";118;73;45;22;42;26;67;
2602063;"Sędziszów (3)";344;210;134;55;118;74;194;
2602064;"Sędziszów - miasto (4)";175;111;64;17;53;39;103;
2602065;"Sędziszów - obszar wiejski (5)";169;99;70;38;65;35;91;
2602072;"Słupia (2)";101;54;47;30;52;13;50;
2602082;"Sobków (2)";245;158;87;44;89;36;134;
2602092;"Wodzisław (2)";202;113;89;38;69;45;120;
2603000;"Powiat kazimierski";1232;601;631;269;487;248;716;
2603012;"Bejsce (2)";139;71;68;30;51;23;86;
2603022;"Czarnocin (2)";126;69;57;43;62;11;64;
2603033;"Kazimierza Wielka (3)";661;305;356;122;241;158;383;
2603034;"Kazimierza Wielka - miasto (4)";222;100;122;24;51;71;135;
2603035;"Kazimierza Wielka - obszar wiejski (5)";439;205;234;98;190;87;248;
2603043;"Opatowiec (3)";73;36;37;16;29;16;42;
2603044;"Opatowiec - miasto (4)";14;6;8;2;5;3;6;
2603045;"Opatowiec - obszar wiejski (5)";59;30;29;14;24;13;36;
2603053;"Skalbmierz (3)";233;120;113;58;104;40;141;
2603054;"Skalbmierz - miasto (4)";58;27;31;9;18;13;38;
2603055;"Skalbmierz - obszar wiejski (5)";175;93;82;49;86;27;103;
2604000;"Powiat kielecki";8091;3984;4107;1204;2579;1695;3777;
2604012;"Bieliny (2)";398;216;182;75;140;61;185;
2604023;"Bodzentyn (3)";667;309;358;134;247;124;410;
2604024;"Bodzentyn - miasto (4)";124;51;73;24;40;33;73;
2604025;"Bodzentyn - obszar wiejski (5)";543;258;285;110;207;91;337;
2604033;"Chęciny (3)";500;248;252;75;163;99;207;
2604034;"Chęciny - miasto (4)";150;77;73;12;39;31;68;
2604035;"Chęciny - obszar wiejski (5)";350;171;179;63;124;68;139;
2604043;"Chmielnik (3)";429;221;208;49;111;125;222;
2604044;"Chmielnik - miasto (4)";126;61;65;15;28;44;58;
2604045;"Chmielnik - obszar wiejski (5)";303;160;143;34;83;81;164;
2604053;"Daleszyce (3)";739;338;401;92;226;158;347;
2604054;"Daleszyce - miasto (4)";133;59;74;16;38;30;72;
2604055;"Daleszyce - obszar wiejski (5)";606;279;327;76;188;128;275;
2604062;"Górno (2)";411;200;211;74;141;68;124;
2604073;"Łagów (3)";273;140;133;61;126;50;148;
2604074;"Łagów - miasto (4)";70;36;34;11;23;19;41;
2604075;"Łagów - obszar wiejski (5)";203;104;99;50;103;31;107;
2604082;"Łopuszno (2)";431;234;197;76;153;85;233;
2604092;"Masłów (2)";418;192;226;46;114;90;189;
2604102;"Miedziana Góra (2)";396;190;206;43;96;77;138;
2604112;"Mniów (2)";474;251;223;59;129;110;251;
2604123;"Morawica (3)";388;180;208;73;137;68;129;
2604124;"Morawica - miasto (4)";45;26;19;11;21;4;10;
2604125;"Morawica - obszar wiejski (5)";343;154;189;62;116;64;119;
2604133;"Nowa Słupia (3)";475;220;255;63;147;117;291;
2604134;"Nowa Słupia - miasto (4)";67;27;40;5;20;18;43;
2604135;"Nowa Słupia - obszar wiejski (5)";408;193;215;58;127;99;248;
2604142;"Piekoszów (2)";544;277;267;69;168;105;202;
2604153;"Pierzchnica (3)";205;100;105;36;70;46;102;
2604154;"Pierzchnica - miasto (4)";54;26;28;8;22;11;24;
2604155;"Pierzchnica - obszar wiejski (5)";151;74;77;28;48;35;78;
2604162;"Raków (2)";210;104;106;24;60;54;104;
2604172;"Nowiny (2)";226;118;108;31;72;43;81;
2604182;"Strawczyn (2)";473;218;255;76;171;97;224;
2604192;"Zagnańsk (2)";434;228;206;48;108;118;190;
2605000;"Powiat konecki";3690;1974;1716;488;984;981;1611;
2605012;"Fałków (2)";135;76;59;13;33;49;58;
2605022;"Gowarczów (2)";232;134;98;31;64;65;106;
2605033;"Końskie (3)";1560;827;733;239;440;371;634;
2605034;"Końskie - miasto (4)";723;372;351;104;198;166;298;
2605035;"Końskie - obszar wiejski (5)";837;455;382;135;242;205;336;
2605043;"Radoszyce (3)";415;227;188;53;118;117;201;
2605044;"Radoszyce - miasto (4)";145;81;64;19;29;49;65;
2605045;"Radoszyce - obszar wiejski (5)";270;146;124;34;89;68;136;
2605052;"Ruda Maleniecka (2)";158;86;72;18;36;54;72;
2605062;"Słupia Konecka (2)";69;35;34;16;31;16;28;
2605072;"Smyków (2)";177;89;88;27;54;35;77;
2605083;"Stąporków (3)";944;500;444;91;208;274;435;
2605084;"Stąporków - miasto (4)";273;140;133;27;56;80;123;
2605085;"Stąporków - obszar wiejski (5)";671;360;311;64;152;194;312;
2606000;"Powiat opatowski";2895;1403;1492;507;941;631;1802;
2606012;"Baćkowice (2)";203;83;120;54;86;34;134;
2606022;"Iwaniska (2)";471;234;237;74;141;101;317;
2606032;"Lipnik (2)";339;161;178;66;114;78;226;
2606043;"Opatów (3)";634;282;352;102;190;156;361;
2606044;"Opatów - miasto (4)";384;160;224;66;113;100;219;
2606045;"Opatów - obszar wiejski (5)";250;122;128;36;77;56;142;
2606053;"Ożarów (3)";562;305;257;93;168;112;346;
2606054;"Ożarów - miasto (4)";206;122;84;23;52;45;131;
2606055;"Ożarów - obszar wiejski (5)";356;183;173;70;116;67;215;
2606062;"Sadowie (2)";177;80;97;26;59;36;107;
2606072;"Tarłów (2)";315;157;158;59;120;71;201;
2606082;"Wojciechowice (2)";194;101;93;33;63;43;110;
2607000;"Powiat ostrowiecki";4301;2260;2041;551;1129;1083;2033;
2607011;"Ostrowiec Świętokrzyski (1)";2611;1410;1201;296;614;676;1197;
2607022;"Bałtów (2)";135;66;69;25;54;33;68;
2607032;"Bodzechów (2)";575;287;288;72;140;143;290;
2607043;"Ćmielów (3)";332;172;160;49;104;85;175;
2607044;"Ćmielów - miasto (4)";142;77;65;22;44;33;73;
2607045;"Ćmielów - obszar wiejski (5)";190;95;95;27;60;52;102;
2607053;"Kunów (3)";451;233;218;57;130;111;214;
2607054;"Kunów - miasto (4)";120;63;57;12;30;25;53;
2607055;"Kunów - obszar wiejski (5)";331;170;161;45;100;86;161;
2607062;"Waśniów (2)";197;92;105;52;87;35;89;
2608000;"Powiat pińczowski";1180;647;533;213;426;251;642;
2608013;"Działoszyce (3)";154;78;76;33;53;34;90;
2608014;"Działoszyce - miasto (4)";48;24;24;2;7;19;27;
2608015;"Działoszyce - obszar wiejski (5)";106;54;52;31;46;15;63;
2608022;"Kije (2)";134;82;52;19;45;21;71;
2608032;"Michałów (2)";104;63;41;19;42;17;55;
2608043;"Pińczów (3)";692;383;309;117;237;163;365;
2608044;"Pińczów - miasto (4)";400;207;193;44;104;116;202;
2608045;"Pińczów - obszar wiejski (5)";292;176;116;73;133;47;163;
2608052;"Złota (2)";96;41;55;25;49;16;61;
2609000;"Powiat sandomierski";2643;1370;1273;430;891;558;1417;
2609011;"Sandomierz (1)";843;429;414;73;203;236;417;
2609022;"Dwikozy (2)";332;167;165;62;122;73;177;
2609033;"Klimontów (3)";331;167;164;76;144;49;187;
2609034;"Klimontów - miasto (4)";77;37;40;12;28;13;38;
2609035;"Klimontów - obszar wiejski (5)";254;130;124;64;116;36;149;
2609043;"Koprzywnica (3)";207;118;89;37;67;39;112;
2609044;"Koprzywnica - miasto (4)";98;53;45;14;28;23;51;
2609045;"Koprzywnica - obszar wiejski (5)";109;65;44;23;39;16;61;
2609052;"Łoniów (2)";187;115;72;20;59;34;106;
2609062;"Obrazów (2)";216;105;111;42;84;32;135;
2609072;"Samborzec (2)";226;117;109;53;96;31;113;
2609082;"Wilczyce (2)";128;59;69;33;54;31;69;
2609093;"Zawichost (3)";173;93;80;34;62;33;101;
2609094;"Zawichost - miasto (4)";70;39;31;11;22;18;38;
2609095;"Zawichost - obszar wiejski (5)";103;54;49;23;40;15;63;
2610000;"Powiat skarżyski";4086;1947;2139;367;869;1172;2103;
2610011;"Skarżysko-Kamienna (1)";2249;1086;1163;199;462;626;1131;
2610022;"Bliżyn (2)";623;300;323;65;153;199;362;
2610032;"Łączna (2)";258;115;143;34;69;62;126;
2610042;"Skarżysko Kościelne (2)";398;180;218;33;80;123;212;
2610053;"Suchedniów (3)";558;266;292;36;105;162;272;
2610054;"Suchedniów - miasto (4)";448;212;236;28;84;129;225;
2610055;"Suchedniów - obszar wiejski (5)";110;54;56;8;21;33;47;
2611000;"Powiat starachowicki";3693;1843;1850;394;882;983;1782;
2611011;"Starachowice (1)";1976;996;980;180;423;555;958;
2611022;"Brody (2)";552;279;273;59;114;146;280;
2611032;"Mirzec (2)";288;130;158;33;76;78;142;
2611042;"Pawłów (2)";517;261;256;84;175;107;215;
2611053;"Wąchock (3)";360;177;183;38;94;97;187;
2611054;"Wąchock - miasto (4)";151;72;79;17;38;44;71;
2611055;"Wąchock - obszar wiejski (5)";209;105;104;21;56;53;116;
2612000;"Powiat staszowski";2276;1308;968;391;747;528;1016;
2612012;"Bogoria (2)";260;133;127;58;114;48;107;
2612022;"Łubnice (2)";86;51;35;27;39;12;35;
2612033;"Oleśnica (3)";90;49;41;15;24;30;42;
2612034;"Oleśnica - miasto (4)";48;22;26;8;10;21;23;
2612035;"Oleśnica - obszar wiejski (5)";42;27;15;7;14;9;19;
2612043;"Osiek (3)";298;179;119;42;85;74;151;
2612044;"Osiek - miasto (4)";60;41;19;9;21;9;26;
2612045;"Osiek - obszar wiejski (5)";238;138;100;33;64;65;125;
2612053;"Połaniec (3)";398;276;122;55;115;87;165;
2612054;"Połaniec - miasto (4)";252;174;78;33;66;54;98;
2612055;"Połaniec - obszar wiejski (5)";146;102;44;22;49;33;67;
2612062;"Rytwiany (2)";206;109;97;37;63;51;93;
2612073;"Staszów (3)";819;452;367;134;265;198;370;
2612074;"Staszów - miasto (4)";446;246;200;59;125;108;192;
2612075;"Staszów - obszar wiejski (5)";373;206;167;75;140;90;178;
2612083;"Szydłów (3)";119;59;60;23;42;28;53;
2612084;"Szydłów - miasto (4)";22;9;13;1;5;7;10;
2612085;"Szydłów - obszar wiejski (5)";97;50;47;22;37;21;43;
2613000;"Powiat włoszczowski";1438;816;622;217;446;345;703;
2613012;"Kluczewsko (2)";163;102;61;33;57;37;84;
2613022;"Krasocin (2)";369;227;142;55;119;77;178;
2613032;"Moskorzew (2)";104;44;60;24;32;32;63;
2613042;"Radków (2)";67;39;28;10;26;16;40;
2613052;"Secemin (2)";167;97;70;23;54;48;75;
2613063;"Włoszczowa (3)";568;307;261;72;158;135;263;
2613064;"Włoszczowa - miasto (4)";291;160;131;31;75;76;125;
2613065;"Włoszczowa - obszar wiejski (5)";277;147;130;41;83;59;138;
2661000;"Powiat m.Kielce";6229;2851;3378;414;1180;1803;3076;
2661011;"Kielce (1)";6229;2851;3378;414;1180;1803;3076;
2800000;"WARMIŃSKO-MAZURSKIE";52928;29074;23854;7099;14593;14098;23865;
2801000;"Powiat bartoszycki";3653;1933;1720;452;932;963;1924;
2801011;"Bartoszyce (1)";1134;576;558;130;276;298;493;
2801021;"Górowo Iławeckie (1)";214;128;86;29;63;52;110;
2801032;"Bartoszyce (2)";797;413;384;117;221;212;406;
2801043;"Bisztynek (3)";422;218;204;56;117;101;241;
2801044;"Bisztynek - miasto (4)";149;72;77;21;49;39;76;
2801045;"Bisztynek - obszar wiejski (5)";273;146;127;35;68;62;165;
2801052;"Górowo Iławeckie (2)";612;345;267;68;146;168;405;
2801063;"Sępopol (3)";474;253;221;52;109;132;269;
2801064;"Sępopol - miasto (4)";135;75;60;15;35;44;66;
2801065;"Sępopol - obszar wiejski (5)";339;178;161;37;74;88;203;
2802000;"Powiat braniewski";2609;1477;1132;383;751;649;1548;
2802011;"Braniewo (1)";794;467;327;115;213;199;399;
2802022;"Braniewo (2)";484;255;229;70;154;116;294;
2802033;"Frombork (3)";164;93;71;20;45;38;97;
2802034;"Frombork - miasto (4)";75;37;38;6;21;18;42;
2802035;"Frombork - obszar wiejski (5)";89;56;33;14;24;20;55;
2802042;"Lelkowo (2)";289;158;131;35;72;70;198;
2802053;"Pieniężno (3)";445;251;194;75;139;109;289;
2802054;"Pieniężno - miasto (4)";128;64;64;11;19;41;81;
2802055;"Pieniężno - obszar wiejski (5)";317;187;130;64;120;68;208;
2802062;"Płoskinia (2)";203;122;81;31;60;55;120;
2802072;"Wilczęta (2)";230;131;99;37;68;62;151;
2803000;"Powiat działdowski";3313;2025;1288;476;896;814;1871;
2803011;"Działdowo (1)";859;499;360;104;213;233;451;
2803022;"Działdowo (2)";626;407;219;89;178;144;384;
2803032;"Iłowo-Osada (2)";365;234;131;64;105;87;207;
2803043;"Lidzbark (3)";800;470;330;115;207;209;469;
2803044;"Lidzbark - miasto (4)";451;269;182;47;98;129;258;
2803045;"Lidzbark - obszar wiejski (5)";349;201;148;68;109;80;211;
2803052;"Płośnica (2)";302;188;114;38;84;67;181;
2803062;"Rybno (2)";361;227;134;66;109;74;179;
2804000;"Powiat elbląski";2972;1763;1209;385;818;751;1627;
2804012;"Elbląg (2)";314;184;130;36;69;89;147;
2804022;"Godkowo (2)";192;104;88;18;43;55;108;
2804032;"Gronowo Elbląskie (2)";191;103;88;25;48;46;87;
2804042;"Markusy (2)";193;130;63;30;65;44;91;
2804052;"Milejewo (2)";126;77;49;17;37;28;60;
2804063;"Młynary (3)";229;133;96;34;73;45;137;
2804064;"Młynary - miasto (4)";80;45;35;15;29;17;44;
2804065;"Młynary - obszar wiejski (5)";149;88;61;19;44;28;93;
2804073;"Pasłęk (3)";1188;704;484;148;341;296;673;
2804074;"Pasłęk - miasto (4)";654;379;275;71;176;158;368;
2804075;"Pasłęk - obszar wiejski (5)";534;325;209;77;165;138;305;
2804082;"Rychliki (2)";291;184;107;36;74;89;201;
2804093;"Tolkmicko (3)";248;144;104;41;68;59;123;
2804094;"Tolkmicko - miasto (4)";88;50;38;14;24;21;38;
2804095;"Tolkmicko - obszar wiejski (5)";160;94;66;27;44;38;85;
2805000;"Powiat ełcki";3932;2139;1793;499;1072;1005;1755;
2805011;"Ełk (1)";2169;1191;978;210;501;570;918;
2805022;"Ełk (2)";883;482;401;147;288;207;412;
2805032;"Kalinowo (2)";318;172;146;50;102;93;163;
2805042;"Prostki (2)";388;204;184;62;127;87;174;
2805052;"Stare Juchy (2)";174;90;84;30;54;48;88;
2806000;"Powiat giżycki";1763;929;834;267;507;495;632;
2806011;"Giżycko (1)";857;448;409;110;225;240;283;
2806042;"Giżycko (2)";248;116;132;42;78;64;87;
2806052;"Kruklanki (2)";92;47;45;12;22;28;44;
2806062;"Miłki (2)";152;97;55;35;53;32;54;
2806083;"Ryn (3)";196;111;85;29;58;62;69;
2806084;"Ryn - miasto (4)";104;61;43;15;33;33;29;
2806085;"Ryn - obszar wiejski (5)";92;50;42;14;25;29;40;
2806102;"Wydminy (2)";218;110;108;39;71;69;95;
2807000;"Powiat iławski";1988;1160;828;358;691;487;547;
2807011;"Iława (1)";631;348;283;95;196;158;118;
2807021;"Lubawa (1)";173;89;84;28;65;39;41;
2807032;"Iława (2)";260;175;85;62;115;46;67;
2807043;"Kisielice (3)";131;86;45;26;41;33;49;
2807044;"Kisielice - miasto (4)";49;30;19;7;15;15;12;
2807045;"Kisielice - obszar wiejski (5)";82;56;26;19;26;18;37;
2807052;"Lubawa (2)";148;84;64;43;70;36;16;
2807063;"Susz (3)";438;244;194;70;136;120;172;
2807064;"Susz - miasto (4)";168;91;77;28;52;45;56;
2807065;"Susz - obszar wiejski (5)";270;153;117;42;84;75;116;
2807073;"Zalewo (3)";207;134;73;34;68;55;84;
2807074;"Zalewo - miasto (4)";56;38;18;8;18;10;21;
2807075;"Zalewo - obszar wiejski (5)";151;96;55;26;50;45;63;
2808000;"Powiat kętrzyński";3597;1851;1746;387;885;1027;1993;
2808011;"Kętrzyn (1)";1297;630;667;124;282;391;613;
2808022;"Barciany (2)";420;227;193;47;106;119;246;
2808032;"Kętrzyn (2)";542;278;264;66;145;142;315;
2808043;"Korsze (3)";710;394;316;65;171;198;448;
2808044;"Korsze - miasto (4)";215;112;103;15;44;54;124;
2808045;"Korsze - obszar wiejski (5)";495;282;213;50;127;144;324;
2808053;"Reszel (3)";384;179;205;52;111;109;220;
2808054;"Reszel - miasto (4)";198;90;108;24;56;56;111;
2808055;"Reszel - obszar wiejski (5)";186;89;97;28;55;53;109;
2808062;"Srokowo (2)";244;143;101;33;70;68;151;
2809000;"Powiat lidzbarski";1977;1145;832;276;587;570;956;
2809011;"Lidzbark Warmiński (1)";578;314;264;81;162;188;237;
2809022;"Kiwity (2)";138;78;60;32;62;30;63;
2809032;"Lidzbark Warmiński (2)";333;183;150;35;92;93;136;
2809042;"Lubomino (2)";215;118;97;36;68;59;129;
2809053;"Orneta (3)";713;452;261;92;203;200;391;
2809054;"Orneta - miasto (4)";455;291;164;51;127;125;242;
2809055;"Orneta - obszar wiejski (5)";258;161;97;41;76;75;149;
2810000;"Powiat mrągowski";1970;938;1032;284;538;571;712;
2810011;"Mrągowo (1)";843;408;435;101;210;253;294;
2810023;"Mikołajki (3)";335;154;181;40;72;107;135;
2810024;"Mikołajki - miasto (4)";124;53;71;4;18;41;55;
2810025;"Mikołajki - obszar wiejski (5)";211;101;110;36;54;66;80;
2810032;"Mrągowo (2)";310;151;159;57;95;87;91;
2810042;"Piecki (2)";275;130;145;57;94;70;96;
2810052;"Sorkwity (2)";207;95;112;29;67;54;96;
2811000;"Powiat nidzicki";830;449;381;101;231;222;300;
2811012;"Janowiec Kościelny (2)";47;29;18;13;17;8;19;
2811022;"Janowo (2)";69;34;35;8;22;22;18;
2811032;"Kozłowo (2)";187;109;78;20;50;53;80;
2811043;"Nidzica (3)";527;277;250;60;142;139;183;
2811044;"Nidzica - miasto (4)";312;145;167;35;72;88;102;
2811045;"Nidzica - obszar wiejski (5)";215;132;83;25;70;51;81;
2812000;"Powiat nowomiejski";1492;915;577;263;505;280;596;
2812011;"Nowe Miasto Lubawskie (1)";378;236;142;66;121;83;138;
2812022;"Biskupiec (2)";367;227;140;46;110;73;169;
2812032;"Grodziczno (2)";188;124;64;42;81;30;82;
2812042;"Kurzętnik (2)";266;150;116;59;94;40;90;
2812052;"Nowe Miasto Lubawskie (2)";293;178;115;50;99;54;117;
2813000;"Powiat olecki";1445;773;672;188;384;415;718;
2813032;"Kowale Oleckie (2)";255;141;114;35;67;85;137;
2813043;"Olecko (3)";803;425;378;103;214;216;377;
2813044;"Olecko - miasto (4)";560;283;277;66;136;150;253;
2813045;"Olecko - obszar wiejski (5)";243;142;101;37;78;66;124;
2813052;"Świętajno (2)";233;126;107;36;67;64;131;
2813062;"Wieliczki (2)";154;81;73;14;36;50;73;
2814000;"Powiat olsztyński";4350;2383;1967;634;1263;1133;1880;
2814013;"Barczewo (3)";563;297;266;82;165;146;216;
2814014;"Barczewo - miasto (4)";209;115;94;34;63;51;78;
2814015;"Barczewo - obszar wiejski (5)";354;182;172;48;102;95;138;
2814023;"Biskupiec (3)";833;469;364;132;251;221;390;
2814024;"Biskupiec - miasto (4)";380;213;167;63;121;100;164;
2814025;"Biskupiec - obszar wiejski (5)";453;256;197;69;130;121;226;
2814033;"Dobre Miasto (3)";751;392;359;102;215;187;374;
2814034;"Dobre Miasto - miasto (4)";457;224;233;58;124;113;233;
2814035;"Dobre Miasto - obszar wiejski (5)";294;168;126;44;91;74;141;
2814042;"Dywity (2)";295;160;135;46;92;70;96;
2814052;"Gietrzwałd (2)";175;96;79;21;44;53;59;
2814063;"Jeziorany (3)";400;232;168;57;111;94;226;
2814064;"Jeziorany - miasto (4)";149;77;72;22;38;33;74;
2814065;"Jeziorany - obszar wiejski (5)";251;155;96;35;73;61;152;
2814072;"Jonkowo (2)";180;100;80;31;59;49;62;
2814082;"Kolno (2)";186;105;81;29;56;46;77;
2814093;"Olsztynek (3)";305;160;145;46;89;95;117;
2814094;"Olsztynek - miasto (4)";151;85;66;21;45;45;51;
2814095;"Olsztynek - obszar wiejski (5)";154;75;79;25;44;50;66;
2814102;"Purda (2)";289;153;136;40;74;82;119;
2814112;"Stawiguda (2)";214;136;78;22;63;42;66;
2814122;"Świątki (2)";159;83;76;26;44;48;78;
2815000;"Powiat ostródzki";4126;2342;1784;587;1185;1093;1802;
2815011;"Ostróda (1)";933;523;410;107;237;254;290;
2815022;"Dąbrówno (2)";174;85;89;24;45;56;78;
2815032;"Grunwald (2)";233;139;94;39;60;61;119;
2815042;"Łukta (2)";193;119;74;29;59;53;101;
2815052;"Małdyty (2)";305;170;135;51;92;80;153;
2815063;"Miłakowo (3)";350;176;174;52;102;101;176;
2815064;"Miłakowo - miasto (4)";125;60;65;22;39;32;61;
2815065;"Miłakowo - obszar wiejski (5)";225;116;109;30;63;69;115;
2815073;"Miłomłyn (3)";185;112;73;36;61;45;78;
2815074;"Miłomłyn - miasto (4)";82;47;35;13;29;22;33;
2815075;"Miłomłyn - obszar wiejski (5)";103;65;38;23;32;23;45;
2815083;"Morąg (3)";1231;710;521;182;357;316;608;
2815084;"Morąg - miasto (4)";573;311;262;77;153;146;256;
2815085;"Morąg - obszar wiejski (5)";658;399;259;105;204;170;352;
2815092;"Ostróda (2)";522;308;214;67;172;127;199;
2816000;"Powiat piski";2162;1197;965;319;629;664;970;
2816013;"Biała Piska (3)";581;329;252;82;169;184;331;
2816014;"Biała Piska - miasto (4)";179;104;75;15;42;61;99;
2816015;"Biała Piska - obszar wiejski (5)";402;225;177;67;127;123;232;
2816023;"Orzysz (3)";318;176;142;49;95;104;147;
2816024;"Orzysz - miasto (4)";198;110;88;29;60;61;85;
2816025;"Orzysz - obszar wiejski (5)";120;66;54;20;35;43;62;
2816033;"Pisz (3)";971;558;413;142;271;286;390;
2816034;"Pisz - miasto (4)";638;365;273;80;162;189;260;
2816035;"Pisz - obszar wiejski (5)";333;193;140;62;109;97;130;
2816043;"Ruciane-Nida (3)";292;134;158;46;94;90;102;
2816044;"Ruciane-Nida - miasto (4)";156;78;78;23;46;50;51;
2816045;"Ruciane-Nida - obszar wiejski (5)";136;56;80;23;48;40;51;
2817000;"Powiat szczycieński";2255;1251;1004;352;702;562;856;
2817011;"Szczytno (1)";714;370;344;92;183;195;267;
2817022;"Dźwierzuty (2)";260;145;115;47;94;72;123;
2817032;"Jedwabno (2)";114;72;42;17;41;27;50;
2817043;"Pasym (3)";160;83;77;20;43;44;48;
2817044;"Pasym - miasto (4)";75;42;33;5;17;22;16;
2817045;"Pasym - obszar wiejski (5)";85;41;44;15;26;22;32;
2817052;"Rozogi (2)";177;97;80;26;66;37;60;
2817062;"Szczytno (2)";394;239;155;64;121;84;141;
2817072;"Świętajno (2)";211;110;101;37;70;53;64;
2817083;"Wielbark (3)";225;135;90;49;84;50;103;
2817084;"Wielbark - miasto (4)";111;68;43;20;35;25;42;
2817085;"Wielbark - obszar wiejski (5)";114;67;47;29;49;25;61;
2818000;"Powiat gołdapski";911;498;413;113;233;283;435;
2818012;"Banie Mazurskie (2)";191;90;101;18;39;84;102;
2818022;"Dubeninki (2)";94;57;37;11;23;25;51;
2818033;"Gołdap (3)";626;351;275;84;171;174;282;
2818034;"Gołdap - miasto (4)";356;187;169;43;89;95;141;
2818035;"Gołdap - obszar wiejski (5)";270;164;106;41;82;79;141;
2819000;"Powiat węgorzewski";1019;490;529;94;207;343;460;
2819012;"Budry (2)";187;100;87;21;44;55;96;
2819022;"Pozezdrze (2)";136;62;74;14;30;42;51;
2819033;"Węgorzewo (3)";696;328;368;59;133;246;313;
2819034;"Węgorzewo - miasto (4)";438;203;235;29;79;151;192;
2819035;"Węgorzewo - obszar wiejski (5)";258;125;133;30;54;95;121;
2861000;"Powiat m.Elbląg";3321;1793;1528;357;756;940;1252;
2861011;"Elbląg (1)";3321;1793;1528;357;756;940;1252;
2862000;"Powiat m.Olsztyn";3243;1623;1620;324;821;831;1031;
2862011;"Olsztyn (1)";3243;1623;1620;324;821;831;1031;
3000000;"WIELKOPOLSKIE";59978;34428;25550;8614;17627;13963;20433;
3001000;"Powiat chodzieski";1589;928;661;204;396;434;717;
3001011;"Chodzież (1)";548;294;254;55;115;169;196;
3001022;"Budzyń (2)";230;155;75;35;66;51;98;
3001032;"Chodzież (2)";189;110;79;21;42;56;84;
3001043;"Margonin (3)";291;175;116;48;90;65;169;
3001044;"Margonin - miasto (4)";111;62;49;19;34;27;53;
3001045;"Margonin - obszar wiejski (5)";180;113;67;29;56;38;116;
3001053;"Szamocin (3)";331;194;137;45;83;93;170;
3001054;"Szamocin - miasto (4)";169;108;61;23;41;42;96;
3001055;"Szamocin - obszar wiejski (5)";162;86;76;22;42;51;74;
3002000;"Powiat czarnkowsko-trzcianecki";1648;889;759;261;500;435;455;
3002011;"Czarnków (1)";158;82;76;23;46;39;24;
3002022;"Czarnków (2)";140;72;68;37;53;31;11;
3002032;"Drawsko (2)";165;86;79;16;47;45;57;
3002043;"Krzyż Wielkopolski (3)";260;146;114;46;81;54;104;
3002044;"Krzyż Wielkopolski - miasto (4)";180;101;79;34;62;33;60;
3002045;"Krzyż Wielkopolski - obszar wiejski (5)";80;45;35;12;19;21;44;
3002052;"Lubasz (2)";88;54;34;22;38;19;9;
3002062;"Połajewo (2)";84;46;38;20;41;19;11;
3002073;"Trzcianka (3)";482;265;217;58;119;141;144;
3002074;"Trzcianka - miasto (4)";333;185;148;39;78;95;98;
3002075;"Trzcianka - obszar wiejski (5)";149;80;69;19;41;46;46;
3002083;"Wieleń (3)";271;138;133;39;75;87;95;
3002084;"Wieleń - miasto (4)";112;60;52;19;32;35;36;
3002085;"Wieleń - obszar wiejski (5)";159;78;81;20;43;52;59;
3003000;"Powiat gnieźnieński";2360;1335;1025;282;589;667;777;
3003011;"Gniezno (1)";1222;678;544;102;245;370;420;
3003023;"Czerniejewo (3)";103;61;42;20;31;28;26;
3003024;"Czerniejewo - miasto (4)";37;18;19;10;12;8;8;
3003025;"Czerniejewo - obszar wiejski (5)";66;43;23;10;19;20;18;
3003032;"Gniezno (2)";172;100;72;23;56;41;49;
3003042;"Kiszkowo (2)";58;31;27;7;21;16;22;
3003053;"Kłecko (3)";103;55;48;12;28;28;22;
3003054;"Kłecko - miasto (4)";38;16;22;4;8;8;7;
3003055;"Kłecko - obszar wiejski (5)";65;39;26;8;20;20;15;
3003062;"Łubowo (2)";68;40;28;9;19;16;20;
3003072;"Mieleszyn (2)";54;35;19;8;13;18;23;
3003082;"Niechanowo (2)";97;56;41;18;34;22;25;
3003093;"Trzemeszno (3)";228;136;92;32;62;60;68;
3003094;"Trzemeszno - miasto (4)";102;65;37;14;26;28;34;
3003095;"Trzemeszno - obszar wiejski (5)";126;71;55;18;36;32;34;
3003103;"Witkowo (3)";255;143;112;51;80;68;102;
3003104;"Witkowo - miasto (4)";131;79;52;26;38;41;50;
3003105;"Witkowo - obszar wiejski (5)";124;64;60;25;42;27;52;
3004000;"Powiat gostyński";1827;1068;759;283;592;408;822;
3004013;"Borek Wielkopolski (3)";151;87;64;31;59;33;67;
3004014;"Borek Wielkopolski - miasto (4)";50;24;26;9;19;11;20;
3004015;"Borek Wielkopolski - obszar wiejski (5)";101;63;38;22;40;22;47;
3004023;"Gostyń (3)";765;439;326;110;228;164;351;
3004024;"Gostyń - miasto (4)";557;307;250;66;161;121;245;
3004025;"Gostyń - obszar wiejski (5)";208;132;76;44;67;43;106;
3004033;"Krobia (3)";262;156;106;50;96;56;116;
3004034;"Krobia - miasto (4)";87;54;33;11;29;23;39;
3004035;"Krobia - obszar wiejski (5)";175;102;73;39;67;33;77;
3004042;"Pępowo (2)";126;68;58;20;43;27;58;
3004052;"Piaski (2)";186;115;71;25;47;43;81;
3004063;"Pogorzela (3)";131;82;49;25;55;26;61;
3004064;"Pogorzela - miasto (4)";60;36;24;12;24;12;33;
3004065;"Pogorzela - obszar wiejski (5)";71;46;25;13;31;14;28;
3004073;"Poniec (3)";206;121;85;22;64;59;88;
3004074;"Poniec - miasto (4)";67;33;34;7;22;18;21;
3004075;"Poniec - obszar wiejski (5)";139;88;51;15;42;41;67;
3005000;"Powiat grodziski";923;548;375;142;297;227;332;
3005012;"Granowo (2)";91;51;40;12;28;21;29;
3005023;"Grodzisk Wielkopolski (3)";394;233;161;50;108;104;155;
3005024;"Grodzisk Wielkopolski - miasto (4)";281;159;122;35;76;82;114;
3005025;"Grodzisk Wielkopolski - obszar wiejski (5)";113;74;39;15;32;22;41;
3005032;"Kamieniec (2)";132;79;53;30;61;33;43;
3005043;"Rakoniewice (3)";221;132;89;32;67;51;74;
3005044;"Rakoniewice - miasto (4)";19;13;6;5;6;6;5;
3005045;"Rakoniewice - obszar wiejski (5)";202;119;83;27;61;45;69;
3005053;"Wielichowo (3)";85;53;32;18;33;18;31;
3005054;"Wielichowo - miasto (4)";26;15;11;2;7;7;12;
3005055;"Wielichowo - obszar wiejski (5)";59;38;21;16;26;11;19;
3006000;"Powiat jarociński";1408;825;583;247;466;319;423;
3006013;"Jaraczewo (3)";157;97;60;34;52;44;59;
3006014;"Jaraczewo - miasto (4)";28;14;14;9;10;11;13;
3006015;"Jaraczewo - obszar wiejski (5)";129;83;46;25;42;33;46;
3006023;"Jarocin (3)";900;521;379;140;281;204;241;
3006024;"Jarocin - miasto (4)";527;296;231;68;146;122;148;
3006025;"Jarocin - obszar wiejski (5)";373;225;148;72;135;82;93;
3006032;"Kotlin (2)";143;78;65;26;59;22;47;
3006043;"Żerków (3)";208;129;79;47;74;49;76;
3006044;"Żerków - miasto (4)";29;12;17;5;7;6;4;
3006045;"Żerków - obszar wiejski (5)";179;117;62;42;67;43;72;
3007000;"Powiat kaliski";856;492;364;158;289;185;321;
3007012;"Blizanów (2)";90;58;32;18;34;15;32;
3007022;"Brzeziny (2)";59;35;24;12;17;15;23;
3007032;"Ceków-Kolonia (2)";40;21;19;7;13;12;16;
3007042;"Godziesze Wielkie (2)";113;68;45;17;33;29;33;
3007052;"Koźminek (2)";69;40;29;20;27;10;26;
3007062;"Lisków (2)";56;29;27;14;19;11;24;
3007072;"Mycielin (2)";57;33;24;10;19;11;20;
3007083;"Opatówek (3)";91;50;41;14;33;10;28;
3007084;"Opatówek - miasto (4)";43;24;19;6;15;4;17;
3007085;"Opatówek - obszar wiejski (5)";48;26;22;8;18;6;11;
3007093;"Stawiszyn (3)";109;66;43;20;40;27;46;
3007094;"Stawiszyn - miasto (4)";31;18;13;6;8;8;18;
3007095;"Stawiszyn - obszar wiejski (5)";78;48;30;14;32;19;28;
3007102;"Szczytniki (2)";81;45;36;12;26;24;39;
3007112;"Żelazków (2)";91;47;44;14;28;21;34;
3008000;"Powiat kępiński";685;415;270;119;209;184;258;
3008012;"Baranów (2)";73;49;24;15;23;22;28;
3008022;"Bralin (2)";56;33;23;12;21;15;17;
3008033;"Kępno (3)";360;210;150;55;100;96;145;
3008034;"Kępno - miasto (4)";217;127;90;27;55;55;91;
3008035;"Kępno - obszar wiejski (5)";143;83;60;28;45;41;54;
3008042;"Łęka Opatowska (2)";45;27;18;14;20;12;15;
3008052;"Perzów (2)";56;33;23;4;12;13;25;
3008062;"Rychtal (2)";51;32;19;8;16;17;15;
3008072;"Trzcinica (2)";44;31;13;11;17;9;13;
3009000;"Powiat kolski";1587;919;668;258;523;353;397;
3009011;"Koło (1)";454;233;221;54;113;125;105;
3009022;"Babiak (2)";140;80;60;42;63;22;32;
3009032;"Chodów (2)";50;29;21;5;13;19;18;
3009043;"Dąbie (3)";109;65;44;13;31;29;31;
3009044;"Dąbie - miasto (4)";52;28;24;6;15;14;10;
3009045;"Dąbie - obszar wiejski (5)";57;37;20;7;16;15;21;
3009052;"Grzegorzew (2)";93;61;32;21;37;15;17;
3009063;"Kłodawa (3)";214;137;77;30;65;38;76;
3009064;"Kłodawa - miasto (4)";137;87;50;13;36;31;46;
3009065;"Kłodawa - obszar wiejski (5)";77;50;27;17;29;7;30;
3009072;"Koło (2)";132;91;41;25;53;27;31;
3009082;"Kościelec (2)";145;77;68;20;49;30;26;
3009092;"Olszówka (2)";64;33;31;12;28;13;11;
3009102;"Osiek Mały (2)";103;61;42;20;42;19;22;
3009113;"Przedecz (3)";83;52;31;16;29;16;28;
3009114;"Przedecz - miasto (4)";41;27;14;4;8;10;15;
3009115;"Przedecz - obszar wiejski (5)";42;25;17;12;21;6;13;
3010000;"Powiat koniński";4280;2588;1692;776;1530;756;2038;
3010013;"Golina (3)";457;271;186;68;146;95;208;
3010014;"Golina - miasto (4)";165;95;70;28;50;41;79;
3010015;"Golina - obszar wiejski (5)";292;176;116;40;96;54;129;
3010022;"Grodziec (2)";114;67;47;29;41;20;41;
3010032;"Kazimierz Biskupi (2)";378;234;144;49;111;76;178;
3010043;"Kleczew (3)";318;199;119;63;113;53;153;
3010044;"Kleczew - miasto (4)";155;100;55;25;45;28;76;
3010045;"Kleczew - obszar wiejski (5)";163;99;64;38;68;25;77;
3010052;"Kramsk (2)";423;252;171;78;161;60;198;
3010062;"Krzymów (2)";247;159;88;44;96;46;110;
3010073;"Rychwał (3)";186;108;78;35;70;27;85;
3010074;"Rychwał - miasto (4)";54;33;21;11;20;11;25;
3010075;"Rychwał - obszar wiejski (5)";132;75;57;24;50;16;60;
3010082;"Rzgów (2)";194;107;87;41;72;35;88;
3010092;"Skulsk (2)";209;118;91;40;76;20;92;
3010103;"Sompolno (3)";368;246;122;68;137;72;200;
3010104;"Sompolno - miasto (4)";139;86;53;27;50;37;65;
3010105;"Sompolno - obszar wiejski (5)";229;160;69;41;87;35;135;
3010112;"Stare Miasto (2)";309;175;134;44;91;69;127;
3010123;"Ślesin (3)";500;300;200;81;177;96;253;
3010124;"Ślesin - miasto (4)";104;54;50;14;28;26;45;
3010125;"Ślesin - obszar wiejski (5)";396;246;150;67;149;70;208;
3010132;"Wierzbinek (2)";306;185;121;77;130;42;162;
3010142;"Wilczyn (2)";271;167;104;59;109;45;143;
3011000;"Powiat kościański";1023;640;383;139;309;233;339;
3011011;"Kościan (1)";346;217;129;39;100;73;125;
3011023;"Czempiń (3)";143;85;58;13;33;29;49;
3011024;"Czempiń - miasto (4)";63;36;27;8;17;11;21;
3011025;"Czempiń - obszar wiejski (5)";80;49;31;5;16;18;28;
3011032;"Kościan (2)";192;121;71;32;63;49;58;
3011043;"Krzywiń (3)";131;80;51;18;37;35;42;
3011044;"Krzywiń - miasto (4)";40;23;17;4;11;6;13;
3011045;"Krzywiń - obszar wiejski (5)";91;57;34;14;26;29;29;
3011053;"Śmigiel (3)";211;137;74;37;76;47;65;
3011054;"Śmigiel - miasto (4)";72;45;27;11;26;13;18;
3011055;"Śmigiel - obszar wiejski (5)";139;92;47;26;50;34;47;
3012000;"Powiat krotoszyński";1414;816;598;207;409;359;485;
3012011;"Sulmierzyce (1)";39;24;15;7;12;7;13;
3012023;"Kobylin (3)";143;81;62;22;44;33;54;
3012024;"Kobylin - miasto (4)";58;34;24;12;23;13;19;
3012025;"Kobylin - obszar wiejski (5)";85;47;38;10;21;20;35;
3012033;"Koźmin Wielkopolski (3)";198;116;82;29;57;43;51;
3012034;"Koźmin Wielkopolski - miasto (4)";112;67;45;13;24;32;28;
3012035;"Koźmin Wielkopolski - obszar wiejski (5)";86;49;37;16;33;11;23;
3012043;"Krotoszyn (3)";842;484;358;121;244;217;297;
3012044;"Krotoszyn - miasto (4)";648;371;277;80;175;176;226;
3012045;"Krotoszyn - obszar wiejski (5)";194;113;81;41;69;41;71;
3012052;"Rozdrażew (2)";54;28;26;8;16;14;20;
3012063;"Zduny (3)";138;83;55;20;36;45;50;
3012064;"Zduny - miasto (4)";81;48;33;9;18;28;34;
3012065;"Zduny - obszar wiejski (5)";57;35;22;11;18;17;16;
3013000;"Powiat leszczyński";878;506;372;163;295;180;290;
3013012;"Krzemieniewo (2)";131;79;52;21;37;36;50;
3013022;"Lipno (2)";142;86;56;26;51;31;57;
3013033;"Osieczna (3)";150;88;62;36;52;24;48;
3013034;"Osieczna - miasto (4)";30;17;13;6;9;5;13;
3013035;"Osieczna - obszar wiejski (5)";120;71;49;30;43;19;35;
3013043;"Rydzyna (3)";150;86;64;20;48;29;39;
3013044;"Rydzyna - miasto (4)";28;16;12;2;9;7;6;
3013045;"Rydzyna - obszar wiejski (5)";122;70;52;18;39;22;33;
3013052;"Święciechowa (2)";134;83;51;20;39;27;43;
3013062;"Wijewo (2)";61;33;28;18;32;10;19;
3013072;"Włoszakowice (2)";110;51;59;22;36;23;34;
3014000;"Powiat międzychodzki";652;404;248;121;217;140;226;
3014012;"Chrzypsko Wielkie (2)";50;30;20;7;13;18;23;
3014022;"Kwilcz (2)";130;87;43;17;37;31;58;
3014033;"Międzychód (3)";333;189;144;71;118;59;92;
3014034;"Międzychód - miasto (4)";167;106;61;34;46;30;50;
3014035;"Międzychód - obszar wiejski (5)";166;83;83;37;72;29;42;
3014043;"Sieraków (3)";139;98;41;26;49;32;53;
3014044;"Sieraków - miasto (4)";101;72;29;16;35;23;38;
3014045;"Sieraków - obszar wiejski (5)";38;26;12;10;14;9;15;
3015000;"Powiat nowotomyski";976;518;458;168;301;216;246;
3015012;"Kuślin (2)";77;45;32;13;20;11;29;
3015023;"Lwówek (3)";163;90;73;47;63;38;48;
3015024;"Lwówek - miasto (4)";9;6;3;3;4;1;2;
3015025;"Lwówek - obszar wiejski (5)";154;84;70;44;59;37;46;
3015032;"Miedzichowo (2)";60;36;24;9;16;18;15;
3015043;"Nowy Tomyśl (3)";353;196;157;43;91;80;71;
3015044;"Nowy Tomyśl - miasto (4)";191;105;86;23;42;43;38;
3015045;"Nowy Tomyśl - obszar wiejski (5)";162;91;71;20;49;37;33;
3015053;"Opalenica (3)";211;95;116;26;64;49;56;
3015054;"Opalenica - miasto (4)";122;61;61;16;37;24;29;
3015055;"Opalenica - obszar wiejski (5)";89;34;55;10;27;25;27;
3015063;"Zbąszyń (3)";112;56;56;30;47;20;27;
3015064;"Zbąszyń - miasto (4)";60;33;27;12;20;11;14;
3015065;"Zbąszyń - obszar wiejski (5)";52;23;29;18;27;9;13;
3016000;"Powiat obornicki";849;484;365;129;254;203;236;
3016013;"Oborniki (3)";486;278;208;71;147;97;141;
3016014;"Oborniki - miasto (4)";269;153;116;38;71;59;81;
3016015;"Oborniki - obszar wiejski (5)";217;125;92;33;76;38;60;
3016023;"Rogoźno (3)";272;150;122;40;68;88;67;
3016024;"Rogoźno - miasto (4)";148;92;56;23;37;45;40;
3016025;"Rogoźno - obszar wiejski (5)";124;58;66;17;31;43;27;
3016032;"Ryczywół (2)";91;56;35;18;39;18;28;
3017000;"Powiat ostrowski";2796;1479;1317;419;835;656;672;
3017011;"Ostrów Wielkopolski (1)";1354;690;664;157;330;349;354;
3017023;"Nowe Skalmierzyce (3)";169;89;80;25;49;34;35;
3017024;"Nowe Skalmierzyce - miasto (4)";55;31;24;9;16;9;14;
3017025;"Nowe Skalmierzyce - obszar wiejski (5)";114;58;56;16;33;25;21;
3017033;"Odolanów (3)";252;130;122;51;98;49;44;
3017034;"Odolanów - miasto (4)";96;48;48;13;31;16;13;
3017035;"Odolanów - obszar wiejski (5)";156;82;74;38;67;33;31;
3017042;"Ostrów Wielkopolski (2)";352;201;151;63;117;80;91;
3017052;"Przygodzice (2)";207;114;93;32;64;48;31;
3017063;"Raszków (3)";180;93;87;43;75;28;30;
3017064;"Raszków - miasto (4)";46;20;26;12;20;13;2;
3017065;"Raszków - obszar wiejski (5)";134;73;61;31;55;15;28;
3017072;"Sieroszewice (2)";161;92;69;25;60;40;47;
3017082;"Sośnie (2)";121;70;51;23;42;28;40;
3018000;"Powiat ostrzeszowski";1153;742;411;192;385;240;471;
3018012;"Czajków (2)";31;22;9;8;14;6;13;
3018022;"Doruchów (2)";98;63;35;16;29;18;32;
3018033;"Grabów nad Prosną (3)";118;90;28;22;43;18;46;
3018034;"Grabów nad Prosną - miasto (4)";25;18;7;6;11;0;11;
3018035;"Grabów nad Prosną - obszar wiejski (5)";93;72;21;16;32;18;35;
3018042;"Kobyla Góra (2)";132;78;54;20;43;27;63;
3018052;"Kraszewice (2)";40;20;20;8;22;4;13;
3018063;"Mikstat (3)";103;69;34;10;31;33;45;
3018064;"Mikstat - miasto (4)";44;28;16;2;11;16;19;
3018065;"Mikstat - obszar wiejski (5)";59;41;18;8;20;17;26;
3018073;"Ostrzeszów (3)";631;400;231;108;203;134;259;
3018074;"Ostrzeszów - miasto (4)";385;230;155;58;123;84;154;
3018075;"Ostrzeszów - obszar wiejski (5)";246;170;76;50;80;50;105;
3019000;"Powiat pilski";2879;1630;1249;397;803;739;872;
3019011;"Piła (1)";1552;816;736;176;377;428;413;
3019022;"Białośliwie (2)";95;65;30;16;24;27;22;
3019032;"Kaczory (2)";129;81;48;22;44;33;42;
3019043;"Łobżenica (3)";207;123;84;36;66;40;93;
3019044;"Łobżenica - miasto (4)";71;40;31;11;18;13;27;
3019045;"Łobżenica - obszar wiejski (5)";136;83;53;25;48;27;66;
3019052;"Miasteczko Krajeńskie (2)";41;25;16;7;13;9;15;
3019062;"Szydłowo (2)";189;112;77;24;54;53;61;
3019073;"Ujście (3)";154;80;74;20;46;34;36;
3019074;"Ujście - miasto (4)";64;27;37;10;23;9;11;
3019075;"Ujście - obszar wiejski (5)";90;53;37;10;23;25;25;
3019083;"Wyrzysk (3)";352;229;123;66;116;89;133;
3019084;"Wyrzysk - miasto (4)";145;98;47;32;54;32;60;
3019085;"Wyrzysk - obszar wiejski (5)";207;131;76;34;62;57;73;
3019093;"Wysoka (3)";160;99;61;30;63;26;57;
3019094;"Wysoka - miasto (4)";48;33;15;7;16;9;17;
3019095;"Wysoka - obszar wiejski (5)";112;66;46;23;47;17;40;
3020000;"Powiat pleszewski";1337;763;574;256;457;255;434;
3020013;"Chocz (3)";100;60;40;22;36;19;28;
3020014;"Chocz - miasto (4)";48;26;22;8;13;11;12;
3020015;"Chocz - obszar wiejski (5)";52;34;18;14;23;8;16;
3020022;"Czermin (2)";86;52;34;19;31;8;30;
3020033;"Dobrzyca (3)";149;81;68;32;60;30;46;
3020034;"Dobrzyca - miasto (4)";58;33;25;9;19;14;21;
3020035;"Dobrzyca - obszar wiejski (5)";91;48;43;23;41;16;25;
3020042;"Gizałki (2)";89;59;30;19;32;15;34;
3020052;"Gołuchów (2)";169;99;70;40;71;31;51;
3020063;"Pleszew (3)";744;412;332;124;227;152;245;
3020064;"Pleszew - miasto (4)";433;229;204;56;115;103;134;
3020065;"Pleszew - obszar wiejski (5)";311;183;128;68;112;49;111;
3021000;"Powiat poznański";3471;2008;1463;352;891;798;850;
3021011;"Luboń (1)";306;166;140;32;82;73;66;
3021021;"Puszczykowo (1)";83;43;40;5;27;21;26;
3021033;"Buk (3)";129;74;55;14;28;42;43;
3021034;"Buk - miasto (4)";71;41;30;9;16;23;23;
3021035;"Buk - obszar wiejski (5)";58;33;25;5;12;19;20;
3021042;"Czerwonak (2)";240;137;103;27;60;58;57;
3021052;"Dopiewo (2)";207;125;82;18;44;39;40;
3021062;"Kleszczewo (2)";59;37;22;7;19;10;14;
3021072;"Komorniki (2)";223;128;95;14;52;38;61;
3021083;"Kostrzyn (3)";178;99;79;21;44;42;53;
3021084;"Kostrzyn - miasto (4)";91;52;39;14;26;20;31;
3021085;"Kostrzyn - obszar wiejski (5)";87;47;40;7;18;22;22;
3021093;"Kórnik (3)";233;135;98;24;47;51;45;
3021094;"Kórnik - miasto (4)";55;31;24;5;9;10;13;
3021095;"Kórnik - obszar wiejski (5)";178;104;74;19;38;41;32;
3021103;"Mosina (3)";296;169;127;28;74;77;85;
3021104;"Mosina - miasto (4)";124;77;47;11;32;28;34;
3021105;"Mosina - obszar wiejski (5)";172;92;80;17;42;49;51;
3021113;"Murowana Goślina (3)";172;108;64;16;53;37;50;
3021114;"Murowana Goślina - miasto (4)";104;65;39;9;30;20;27;
3021115;"Murowana Goślina - obszar wiejski (5)";68;43;25;7;23;17;23;
3021123;"Pobiedziska (3)";185;105;80;24;44;50;45;
3021124;"Pobiedziska - miasto (4)";101;56;45;12;24;27;25;
3021125;"Pobiedziska - obszar wiejski (5)";84;49;35;12;20;23;20;
3021132;"Rokietnica (2)";146;86;60;10;41;27;24;
3021143;"Stęszew (3)";169;97;72;24;49;50;49;
3021144;"Stęszew - miasto (4)";58;33;25;10;16;18;11;
3021145;"Stęszew - obszar wiejski (5)";111;64;47;14;33;32;38;
3021152;"Suchy Las (2)";133;74;59;17;40;29;22;
3021163;"Swarzędz (3)";468;280;188;49;121;106;94;
3021164;"Swarzędz - miasto (4)";293;174;119;34;76;77;62;
3021165;"Swarzędz - obszar wiejski (5)";175;106;69;15;45;29;32;
3021172;"Tarnowo Podgórne (2)";244;145;99;22;66;48;76;
3022000;"Powiat rawicki";1174;715;459;269;433;233;409;
3022013;"Bojanowo (3)";202;122;80;38;70;43;86;
3022014;"Bojanowo - miasto (4)";61;38;23;9;19;14;25;
3022015;"Bojanowo - obszar wiejski (5)";141;84;57;29;51;29;61;
3022023;"Jutrosin (3)";113;74;39;37;54;24;32;
3022024;"Jutrosin - miasto (4)";40;30;10;11;16;8;9;
3022025;"Jutrosin - obszar wiejski (5)";73;44;29;26;38;16;23;
3022033;"Miejska Górka (3)";163;100;63;42;67;34;58;
3022034;"Miejska Górka - miasto (4)";73;45;28;13;26;21;24;
3022035;"Miejska Górka - obszar wiejski (5)";90;55;35;29;41;13;34;
3022042;"Pakosław (2)";66;40;26;27;36;9;23;
3022053;"Rawicz (3)";630;379;251;125;206;123;210;
3022054;"Rawicz - miasto (4)";448;260;188;71;136;91;160;
3022055;"Rawicz - obszar wiejski (5)";182;119;63;54;70;32;50;
3023000;"Powiat słupecki";1831;1087;744;343;676;348;802;
3023011;"Słupca (1)";445;267;178;73;146;111;191;
3023022;"Lądek (2)";149;88;61;28;59;18;65;
3023032;"Orchowo (2)";134;82;52;28;49;22;85;
3023042;"Ostrowite (2)";162;96;66;32;58;25;78;
3023052;"Powidz (2)";63;36;27;7;22;12;29;
3023062;"Słupca (2)";346;210;136;68;129;55;143;
3023072;"Strzałkowo (2)";289;166;123;54;112;52;113;
3023083;"Zagórów (3)";243;142;101;53;101;53;98;
3023084;"Zagórów - miasto (4)";79;48;31;9;25;12;31;
3023085;"Zagórów - obszar wiejski (5)";164;94;70;44;76;41;67;
3024000;"Powiat szamotulski";1321;803;518;180;352;308;440;
3024011;"Obrzycko (1)";39;23;16;2;9;14;18;
3024022;"Duszniki (2)";118;74;44;22;38;17;46;
3024032;"Kaźmierz (2)";119;72;47;13;29;34;37;
3024042;"Obrzycko (2)";88;58;30;10;24;21;37;
3024053;"Ostroróg (3)";94;48;46;12;18;22;41;
3024054;"Ostroróg - miasto (4)";40;19;21;5;8;10;17;
3024055;"Ostroróg - obszar wiejski (5)";54;29;25;7;10;12;24;
3024063;"Pniewy (3)";189;118;71;21;45;49;49;
3024064;"Pniewy - miasto (4)";114;71;43;15;31;28;24;
3024065;"Pniewy - obszar wiejski (5)";75;47;28;6;14;21;25;
3024073;"Szamotuły (3)";495;288;207;64;132;113;157;
3024074;"Szamotuły - miasto (4)";316;187;129;43;85;63;100;
3024075;"Szamotuły - obszar wiejski (5)";179;101;78;21;47;50;57;
3024083;"Wronki (3)";179;122;57;36;57;38;55;
3024084;"Wronki - miasto (4)";114;75;39;23;35;26;33;
3024085;"Wronki - obszar wiejski (5)";65;47;18;13;22;12;22;
3025000;"Powiat średzki";1761;1065;696;251;497;400;724;
3025012;"Dominowo (2)";107;76;31;18;37;24;57;
3025022;"Krzykosy (2)";179;120;59;32;62;25;50;
3025032;"Nowe Miasto nad Wartą (2)";263;159;104;39;79;64;119;
3025043;"Środa Wielkopolska (3)";1040;613;427;139;268;243;424;
3025044;"Środa Wielkopolska - miasto (4)";701;393;308;89;184;172;263;
3025045;"Środa Wielkopolska - obszar wiejski (5)";339;220;119;50;84;71;161;
3025052;"Zaniemyśl (2)";172;97;75;23;51;44;74;
3026000;"Powiat śremski";692;401;291;122;208;153;134;
3026012;"Brodnica (2)";71;42;29;9;23;14;23;
3026023;"Dolsk (3)";65;34;31;21;27;12;15;
3026024;"Dolsk - miasto (4)";19;10;9;5;6;4;4;
3026025;"Dolsk - obszar wiejski (5)";46;24;22;16;21;8;11;
3026033;"Książ Wielkopolski (3)";103;65;38;18;28;22;26;
3026034;"Książ Wielkopolski - miasto (4)";33;17;16;4;7;10;5;
3026035;"Książ Wielkopolski - obszar wiejski (5)";70;48;22;14;21;12;21;
3026043;"Śrem (3)";453;260;193;74;130;105;70;
3026044;"Śrem - miasto (4)";345;194;151;53;94;82;53;
3026045;"Śrem - obszar wiejski (5)";108;66;42;21;36;23;17;
3027000;"Powiat turecki";1779;1059;720;258;546;382;543;
3027011;"Turek (1)";619;358;261;59;146;156;205;
3027022;"Brudzew (2)";150;89;61;28;58;26;49;
3027033;"Dobra (3)";90;45;45;15;29;24;31;
3027034;"Dobra - miasto (4)";16;8;8;4;7;5;5;
3027035;"Dobra - obszar wiejski (5)";74;37;37;11;22;19;26;
3027042;"Kawęczyn (2)";89;58;31;22;36;11;29;
3027052;"Malanów (2)";109;71;38;21;37;22;30;
3027062;"Przykona (2)";96;61;35;13;31;22;20;
3027073;"Tuliszków (3)";204;125;79;24;59;54;64;
3027074;"Tuliszków - miasto (4)";60;46;14;5;15;21;23;
3027075;"Tuliszków - obszar wiejski (5)";144;79;65;19;44;33;41;
3027082;"Turek (2)";184;118;66;39;67;27;40;
3027092;"Władysławów (2)";238;134;104;37;83;40;75;
3028000;"Powiat wągrowiecki";1477;873;604;242;457;322;509;
3028011;"Wągrowiec (1)";565;329;236;86;161;115;187;
3028022;"Damasławek (2)";118;73;45;22;39;30;54;
3028033;"Gołańcz (3)";165;103;62;38;58;35;63;
3028034;"Gołańcz - miasto (4)";63;40;23;16;23;17;22;
3028035;"Gołańcz - obszar wiejski (5)";102;63;39;22;35;18;41;
3028042;"Mieścisko (2)";123;64;59;24;44;29;44;
3028053;"Skoki (3)";177;112;65;25;55;40;56;
3028054;"Skoki - miasto (4)";75;48;27;9;21;14;17;
3028055;"Skoki - obszar wiejski (5)";102;64;38;16;34;26;39;
3028062;"Wapno (2)";83;51;32;11;26;26;37;
3028072;"Wągrowiec (2)";246;141;105;36;74;47;68;
3029000;"Powiat wolsztyński";639;360;279;115;217;168;167;
3029012;"Przemęt (2)";144;80;64;24;53;31;37;
3029022;"Siedlec (2)";119;72;47;16;38;29;32;
3029033;"Wolsztyn (3)";376;208;168;75;126;108;98;
3029034;"Wolsztyn - miasto (4)";182;98;84;36;62;47;52;
3029035;"Wolsztyn - obszar wiejski (5)";194;110;84;39;64;61;46;
3030000;"Powiat wrzesiński";1562;919;643;254;486;368;491;
3030012;"Kołaczkowo (2)";130;82;48;26;42;30;49;
3030023;"Miłosław (3)";214;128;86;34;67;52;76;
3030024;"Miłosław - miasto (4)";84;46;38;13;24;27;26;
3030025;"Miłosław - obszar wiejski (5)";130;82;48;21;43;25;50;
3030033;"Nekla (3)";112;64;48;20;44;23;34;
3030034;"Nekla - miasto (4)";49;22;27;9;21;9;11;
3030035;"Nekla - obszar wiejski (5)";63;42;21;11;23;14;23;
3030043;"Pyzdry (3)";199;122;77;45;69;39;63;
3030044;"Pyzdry - miasto (4)";89;48;41;20;31;17;22;
3030045;"Pyzdry - obszar wiejski (5)";110;74;36;25;38;22;41;
3030053;"Września (3)";907;523;384;129;264;224;269;
3030054;"Września - miasto (4)";621;354;267;76;169;157;174;
3030055;"Września - obszar wiejski (5)";286;169;117;53;95;67;95;
3031000;"Powiat złotowski";2004;1140;864;301;602;482;827;
3031011;"Złotów (1)";474;249;225;71;144;119;192;
3031023;"Jastrowie (3)";400;238;162;52;109;93;185;
3031024;"Jastrowie - miasto (4)";273;167;106;34;74;56;119;
3031025;"Jastrowie - obszar wiejski (5)";127;71;56;18;35;37;66;
3031033;"Krajenka (3)";195;117;78;24;60;43;88;
3031034;"Krajenka - miasto (4)";98;61;37;10;23;25;44;
3031035;"Krajenka - obszar wiejski (5)";97;56;41;14;37;18;44;
3031042;"Lipka (2)";173;101;72;27;49;49;78;
3031053;"Okonek (3)";214;109;105;29;57;50;70;
3031054;"Okonek - miasto (4)";90;36;54;11;21;18;22;
3031055;"Okonek - obszar wiejski (5)";124;73;51;18;36;32;48;
3031062;"Tarnówka (2)";101;58;43;13;35;19;35;
3031072;"Zakrzewo (2)";111;61;50;20;37;27;38;
3031082;"Złotów (2)";336;207;129;65;111;82;141;
3061000;"Powiat m.Kalisz";1632;867;765;157;383;440;590;
3061011;"Kalisz (1)";1632;867;765;157;383;440;590;
3062000;"Powiat m.Konin";2366;1303;1063;261;574;557;1130;
3062011;"Konin (1)";2366;1303;1063;261;574;557;1130;
3063000;"Powiat m.Leszno";1248;723;525;154;316;314;486;
3063011;"Leszno (1)";1248;723;525;154;316;314;486;
3064000;"Powiat m.Poznań";5901;3116;2785;434;1333;1501;1520;
3064011;"Poznań (1)";5901;3116;2785;434;1333;1501;1520;
3200000;"ZACHODNIOPOMORSKIE";49788;27372;22416;5807;12671;13506;22033;
3201000;"Powiat białogardzki";2856;1558;1298;342;714;758;1569;
3201011;"Białogard (1)";1232;659;573;146;295;333;626;
3201022;"Białogard (2)";543;297;246;63;143;142;317;
3201033;"Karlino (3)";591;327;264;76;153;160;337;
3201034;"Karlino - miasto (4)";349;187;162;49;87;88;191;
3201035;"Karlino - obszar wiejski (5)";242;140;102;27;66;72;146;
3201043;"Tychowo (3)";490;275;215;57;123;123;289;
3201044;"Tychowo - miasto (4)";121;55;66;18;31;24;58;
3201045;"Tychowo - obszar wiejski (5)";369;220;149;39;92;99;231;
3202000;"Powiat choszczeński";2290;1327;963;324;642;538;1203;
3202012;"Bierzwnik (2)";269;149;120;44;88;66;137;
3202023;"Choszczno (3)";785;452;333;98;202;181;388;
3202024;"Choszczno - miasto (4)";459;265;194;48;107;107;201;
3202025;"Choszczno - obszar wiejski (5)";326;187;139;50;95;74;187;
3202033;"Drawno (3)";282;150;132;32;72;87;164;
3202034;"Drawno - miasto (4)";107;57;50;13;31;27;51;
3202035;"Drawno - obszar wiejski (5)";175;93;82;19;41;60;113;
3202042;"Krzęcin (2)";197;119;78;27;54;52;118;
3202053;"Pełczyce (3)";418;250;168;64;110;90;208;
3202054;"Pełczyce - miasto (4)";134;76;58;17;28;40;67;
3202055;"Pełczyce - obszar wiejski (5)";284;174;110;47;82;50;141;
3202063;"Recz (3)";339;207;132;59;116;62;188;
3202064;"Recz - miasto (4)";126;83;43;19;42;20;61;
3202065;"Recz - obszar wiejski (5)";213;124;89;40;74;42;127;
3203000;"Powiat drawski";2709;1465;1244;335;745;750;1347;
3203013;"Czaplinek (3)";645;347;298;89;186;175;310;
3203014;"Czaplinek - miasto (4)";345;185;160;48;96;94;152;
3203015;"Czaplinek - obszar wiejski (5)";300;162;138;41;90;81;158;
3203023;"Drawsko Pomorskie (3)";638;331;307;88;186;172;296;
3203024;"Drawsko Pomorskie - miasto (4)";375;182;193;46;105;110;167;
3203025;"Drawsko Pomorskie - obszar wiejski (5)";263;149;114;42;81;62;129;
3203033;"Kalisz Pomorski (3)";330;206;124;34;76;95;176;
3203034;"Kalisz Pomorski - miasto (4)";154;98;56;18;30;43;72;
3203035;"Kalisz Pomorski - obszar wiejski (5)";176;108;68;16;46;52;104;
3203052;"Wierzchowo (2)";203;133;70;25;67;52;115;
3203063;"Złocieniec (3)";893;448;445;99;230;256;450;
3203064;"Złocieniec - miasto (4)";683;354;329;76;167;187;341;
3203065;"Złocieniec - obszar wiejski (5)";210;94;116;23;63;69;109;
3204000;"Powiat goleniowski";2071;1232;839;277;572;519;793;
3204023;"Goleniów (3)";685;398;287;64;168;174;195;
3204024;"Goleniów - miasto (4)";411;233;178;35;96;106;120;
3204025;"Goleniów - obszar wiejski (5)";274;165;109;29;72;68;75;
3204033;"Maszewo (3)";244;153;91;52;82;60;100;
3204034;"Maszewo - miasto (4)";98;62;36;21;33;25;34;
3204035;"Maszewo - obszar wiejski (5)";146;91;55;31;49;35;66;
3204043;"Nowogard (3)";780;455;325;110;215;197;339;
3204044;"Nowogard - miasto (4)";428;242;186;48;96;121;158;
3204045;"Nowogard - obszar wiejski (5)";352;213;139;62;119;76;181;
3204052;"Osina (2)";100;66;34;17;31;28;34;
3204062;"Przybiernów (2)";133;84;49;17;41;29;71;
3204073;"Stepnica (3)";129;76;53;17;35;31;54;
3204074;"Stepnica - miasto (4)";55;32;23;9;14;10;17;
3204075;"Stepnica - obszar wiejski (5)";74;44;30;8;21;21;37;
3205000;"Powiat gryficki";1755;1015;740;252;545;382;541;
3205012;"Brojce (2)";101;51;50;15;36;26;36;
3205023;"Gryfice (3)";721;417;304;97;219;136;225;
3205024;"Gryfice - miasto (4)";465;264;201;53;121;96;146;
3205025;"Gryfice - obszar wiejski (5)";256;153;103;44;98;40;79;
3205032;"Karnice (2)";136;72;64;19;47;34;39;
3205043;"Płoty (3)";354;217;137;59;121;73;127;
3205044;"Płoty - miasto (4)";127;84;43;15;42;24;49;
3205045;"Płoty - obszar wiejski (5)";227;133;94;44;79;49;78;
3205072;"Rewal (2)";82;43;39;7;19;25;16;
3205083;"Trzebiatów (3)";361;215;146;55;103;88;98;
3205084;"Trzebiatów - miasto (4)";202;124;78;30;55;49;50;
3205085;"Trzebiatów - obszar wiejski (5)";159;91;68;25;48;39;48;
3206000;"Powiat gryfiński";2193;1325;868;273;577;624;1218;
3206012;"Banie (2)";134;88;46;19;39;33;70;
3206023;"Cedynia (3)";215;119;96;24;50;79;134;
3206024;"Cedynia - miasto (4)";66;29;37;5;11;26;34;
3206025;"Cedynia - obszar wiejski (5)";149;90;59;19;39;53;100;
3206033;"Chojna (3)";569;346;223;76;143;173;347;
3206034;"Chojna - miasto (4)";212;133;79;30;52;59;111;
3206035;"Chojna - obszar wiejski (5)";357;213;144;46;91;114;236;
3206043;"Gryfino (3)";412;253;159;41;114;94;151;
3206044;"Gryfino - miasto (4)";283;177;106;24;80;57;98;
3206045;"Gryfino - obszar wiejski (5)";129;76;53;17;34;37;53;
3206053;"Mieszkowice (3)";267;165;102;33;79;76;168;
3206054;"Mieszkowice - miasto (4)";115;68;47;14;34;30;67;
3206055;"Mieszkowice - obszar wiejski (5)";152;97;55;19;45;46;101;
3206063;"Moryń (3)";168;96;72;20;40;50;103;
3206064;"Moryń - miasto (4)";57;31;26;4;10;19;32;
3206065;"Moryń - obszar wiejski (5)";111;65;46;16;30;31;71;
3206072;"Stare Czarnowo (2)";60;33;27;10;15;14;33;
3206083;"Trzcińsko-Zdrój (3)";209;117;92;25;52;65;130;
3206084;"Trzcińsko-Zdrój - miasto (4)";75;29;46;6;16;29;40;
3206085;"Trzcińsko-Zdrój - obszar wiejski (5)";134;88;46;19;36;36;90;
3206092;"Widuchowa (2)";159;108;51;25;45;40;82;
3207000;"Powiat kamieński";2211;1212;999;251;544;552;1230;
3207013;"Dziwnów (3)";184;99;85;13;30;55;94;
3207014;"Dziwnów - miasto (4)";111;54;57;7;21;33;53;
3207015;"Dziwnów - obszar wiejski (5)";73;45;28;6;9;22;41;
3207023;"Golczewo (3)";264;137;127;46;79;63;152;
3207024;"Golczewo - miasto (4)";107;57;50;19;29;24;57;
3207025;"Golczewo - obszar wiejski (5)";157;80;77;27;50;39;95;
3207033;"Kamień Pomorski (3)";698;352;346;87;189;173;357;
3207034;"Kamień Pomorski - miasto (4)";405;185;220;44;101;103;192;
3207035;"Kamień Pomorski - obszar wiejski (5)";293;167;126;43;88;70;165;
3207043;"Międzyzdroje (3)";200;106;94;9;38;56;112;
3207044;"Międzyzdroje - miasto (4)";164;88;76;5;32;45;94;
3207045;"Międzyzdroje - obszar wiejski (5)";36;18;18;4;6;11;18;
3207052;"Świerzno (2)";261;155;106;34;67;54;138;
3207063;"Wolin (3)";604;363;241;62;141;151;377;
3207064;"Wolin - miasto (4)";205;128;77;22;49;48;119;
3207065;"Wolin - obszar wiejski (5)";399;235;164;40;92;103;258;
3208000;"Powiat kołobrzeski";1054;500;554;104;253;316;121;
3208011;"Kołobrzeg (1)";632;303;329;44;131;207;73;
3208022;"Dygowo (2)";79;34;45;11;26;17;3;
3208033;"Gościno (3)";76;38;38;13;31;17;8;
3208034;"Gościno - miasto (4)";36;21;15;6;16;8;3;
3208035;"Gościno - obszar wiejski (5)";40;17;23;7;15;9;5;
3208042;"Kołobrzeg (2)";122;55;67;16;30;29;15;
3208052;"Rymań (2)";64;35;29;9;17;24;10;
3208062;"Siemyśl (2)";41;20;21;5;7;9;8;
3208072;"Ustronie Morskie (2)";40;15;25;6;11;13;4;
3209000;"Powiat koszaliński";2811;1626;1185;325;716;811;1357;
3209012;"Będzino (2)";345;182;163;35;79;107;166;
3209022;"Biesiekierz (2)";237;127;110;13;53;70;116;
3209033;"Bobolice (3)";499;309;190;75;157;150;236;
3209034;"Bobolice - miasto (4)";175;100;75;18;43;63;68;
3209035;"Bobolice - obszar wiejski (5)";324;209;115;57;114;87;168;
3209042;"Manowo (2)";239;146;93;30;62;55;110;
3209053;"Mielno (3)";164;89;75;17;35;49;71;
3209054;"Mielno - miasto (4)";86;45;41;4;12;33;40;
3209055;"Mielno - obszar wiejski (5)";78;44;34;13;23;16;31;
3209063;"Polanów (3)";449;279;170;66;122;122;233;
3209064;"Polanów - miasto (4)";110;65;45;22;39;24;48;
3209065;"Polanów - obszar wiejski (5)";339;214;125;44;83;98;185;
3209073;"Sianów (3)";618;356;262;66;142;179;306;
3209074;"Sianów - miasto (4)";278;156;122;25;65;87;123;
3209075;"Sianów - obszar wiejski (5)";340;200;140;41;77;92;183;
3209082;"Świeszyno (2)";260;138;122;23;66;79;119;
3210000;"Powiat myśliborski";1615;881;734;200;426;438;686;
3210013;"Barlinek (3)";472;242;230;61;129;135;192;
3210014;"Barlinek - miasto (4)";317;157;160;39;85;89;118;
3210015;"Barlinek - obszar wiejski (5)";155;85;70;22;44;46;74;
3210022;"Boleszkowice (2)";72;37;35;9;18;23;28;
3210033;"Dębno (3)";543;303;240;64;135;135;246;
3210034;"Dębno - miasto (4)";346;181;165;39;78;91;158;
3210035;"Dębno - obszar wiejski (5)";197;122;75;25;57;44;88;
3210043;"Myślibórz (3)";421;231;190;49;108;124;165;
3210044;"Myślibórz - miasto (4)";126;60;66;1;20;39;50;
3210045;"Myślibórz - obszar wiejski (5)";295;171;124;48;88;85;115;
3210052;"Nowogródek Pomorski (2)";107;68;39;17;36;21;55;
3211000;"Powiat policki";1566;919;647;158;372;404;674;
3211012;"Dobra (Szczecińska) (2)";389;245;144;29;88;102;196;
3211022;"Kołbaskowo (2)";267;162;105;21;57;61;114;
3211033;"Nowe Warpno (3)";71;38;33;5;15;20;38;
3211034;"Nowe Warpno - miasto (4)";47;23;24;3;12;13;26;
3211035;"Nowe Warpno - obszar wiejski (5)";24;15;9;2;3;7;12;
3211043;"Police (3)";839;474;365;103;212;221;326;
3211044;"Police - miasto (4)";682;388;294;87;175;177;261;
3211045;"Police - obszar wiejski (5)";157;86;71;16;37;44;65;
3212000;"Powiat pyrzycki";1465;852;613;178;404;391;695;
3212012;"Bielice (2)";83;55;28;12;20;21;26;
3212022;"Kozielice (2)";139;77;62;18;35;45;75;
3212033;"Lipiany (3)";339;199;140;28;81;85;189;
3212034;"Lipiany - miasto (4)";221;124;97;21;58;59;118;
3212035;"Lipiany - obszar wiejski (5)";118;75;43;7;23;26;71;
3212042;"Przelewice (2)";219;131;88;31;61;70;121;
3212053;"Pyrzyce (3)";578;331;247;77;169;144;239;
3212054;"Pyrzyce - miasto (4)";350;183;167;41;92;95;149;
3212055;"Pyrzyce - obszar wiejski (5)";228;148;80;36;77;49;90;
3212062;"Warnice (2)";107;59;48;12;38;26;45;
3213000;"Powiat sławieński";2431;1337;1094;329;653;700;1249;
3213011;"Darłowo (1)";514;269;245;58;113;152;232;
3213021;"Sławno (1)";568;309;259;72;142;169;323;
3213032;"Darłowo (2)";275;134;141;43;85;79;132;
3213042;"Malechowo (2)";310;180;130;40;87;93;171;
3213052;"Postomino (2)";278;152;126;52;83;74;136;
3213062;"Sławno (2)";486;293;193;64;143;133;255;
3214000;"Powiat stargardzki";3137;1867;1270;420;882;773;1411;
3214011;"Stargard (1)";1634;959;675;208;432;384;666;
3214023;"Chociwel (3)";198;132;66;26;59;49;108;
3214024;"Chociwel - miasto (4)";87;60;27;11;22;21;39;
3214025;"Chociwel - obszar wiejski (5)";111;72;39;15;37;28;69;
3214033;"Dobrzany (3)";166;98;68;26;49;35;78;
3214034;"Dobrzany - miasto (4)";14;8;6;0;0;6;6;
3214035;"Dobrzany - obszar wiejski (5)";152;90;62;26;49;29;72;
3214042;"Dolice (2)";245;164;81;27;74;49;130;
3214053;"Ińsko (3)";101;52;49;13;27;37;60;
3214054;"Ińsko - miasto (4)";42;25;17;6;15;13;25;
3214055;"Ińsko - obszar wiejski (5)";59;27;32;7;12;24;35;
3214062;"Kobylanka (2)";115;74;41;12;27;38;45;
3214082;"Marianowo (2)";82;49;33;15;27;19;38;
3214092;"Stara Dąbrowa (2)";142;79;63;27;48;39;73;
3214102;"Stargard (2)";331;197;134;43;97;88;155;
3214113;"Suchań (3)";123;63;60;23;42;35;58;
3214114;"Suchań - miasto (4)";39;15;24;6;12;12;15;
3214115;"Suchań - obszar wiejski (5)";84;48;36;17;30;23;43;
3215000;"Powiat szczecinecki";4107;2266;1841;580;1195;1058;2028;
3215011;"Szczecinek (1)";1703;940;763;226;474;426;749;
3215023;"Barwice (3)";699;378;321;99;198;187;429;
3215024;"Barwice - miasto (4)";260;138;122;32;65;65;156;
3215025;"Barwice - obszar wiejski (5)";439;240;199;67;133;122;273;
3215033;"Biały Bór (3)";355;205;150;40;96;93;198;
3215034;"Biały Bór - miasto (4)";111;67;44;13;33;27;60;
3215035;"Biały Bór - obszar wiejski (5)";244;138;106;27;63;66;138;
3215043;"Borne Sulinowo (3)";457;237;220;74;155;109;218;
3215044;"Borne Sulinowo - miasto (4)";181;91;90;33;73;41;78;
3215045;"Borne Sulinowo - obszar wiejski (5)";276;146;130;41;82;68;140;
3215052;"Grzmiąca (2)";323;177;146;60;115;87;158;
3215062;"Szczecinek (2)";570;329;241;81;157;156;276;
3216000;"Powiat świdwiński";2080;1171;909;244;558;497;926;
3216011;"Świdwin (1)";566;337;229;51;135;132;229;
3216022;"Brzeżno (2)";144;76;68;20;47;35;71;
3216033;"Połczyn-Zdrój (3)";743;426;317;93;206;177;349;
3216034;"Połczyn-Zdrój - miasto (4)";381;221;160;44;99;84;168;
3216035;"Połczyn-Zdrój - obszar wiejski (5)";362;205;157;49;107;93;181;
3216042;"Rąbino (2)";178;83;95;22;46;43;79;
3216052;"Sławoborze (2)";171;92;79;16;40;41;66;
3216062;"Świdwin (2)";278;157;121;42;84;69;132;
3217000;"Powiat wałecki";1539;894;645;188;384;432;661;
3217011;"Wałcz (1)";641;346;295;63;140;182;253;
3217023;"Człopa (3)";163;100;63;21;41;55;83;
3217024;"Człopa - miasto (4)";66;41;25;10;14;24;35;
3217025;"Człopa - obszar wiejski (5)";97;59;38;11;27;31;48;
3217033;"Mirosławiec (3)";169;114;55;23;49;35;73;
3217034;"Mirosławiec - miasto (4)";91;58;33;13;31;16;31;
3217035;"Mirosławiec - obszar wiejski (5)";78;56;22;10;18;19;42;
3217043;"Tuczno (3)";111;54;57;15;34;36;50;
3217044;"Tuczno - miasto (4)";39;17;22;2;7;12;13;
3217045;"Tuczno - obszar wiejski (5)";72;37;35;13;27;24;37;
3217052;"Wałcz (2)";455;280;175;66;120;124;202;
3218000;"Powiat łobeski";1966;1114;852;258;520;512;1153;
3218013;"Dobra (3)";224;127;97;18;52;66;122;
3218014;"Dobra - miasto (4)";123;75;48;8;21;35;66;
3218015;"Dobra - obszar wiejski (5)";101;52;49;10;31;31;56;
3218023;"Łobez (3)";624;357;267;83;167;143;327;
3218024;"Łobez - miasto (4)";397;219;178;54;111;84;199;
3218025;"Łobez - obszar wiejski (5)";227;138;89;29;56;59;128;
3218032;"Radowo Małe (2)";229;136;93;35;58;70;145;
3218043;"Resko (3)";544;271;273;74;153;142;352;
3218044;"Resko - miasto (4)";230;117;113;28;58;57;151;
3218045;"Resko - obszar wiejski (5)";314;154;160;46;95;85;201;
3218053;"Węgorzyno (3)";345;223;122;48;90;91;207;
3218054;"Węgorzyno - miasto (4)";105;65;40;16;31;25;50;
3218055;"Węgorzyno - obszar wiejski (5)";240;158;82;32;59;66;157;
3261000;"Powiat m.Koszalin";2974;1470;1504;215;587;924;1267;
3261011;"Koszalin (1)";2974;1470;1504;215;587;924;1267;
3262000;"Powiat m.Szczecin";6169;2930;3239;486;1223;1877;1688;
3262011;"Szczecin (1)";6169;2930;3239;486;1223;1877;1688;
3263000;"Powiat m.Świnoujście";789;411;378;68;159;250;216;
3263011;"Świnoujście (1)";789;411;378;68;159;250;216;
